Wwg, Wwg, Wwg, Ds, Ds^Ewsh, Mm, Mm^Xm, Mm^Xm, Mm^Xm, Mm, Mm, Mm, Mm, Mm, Mm, Mm, Mm, Mm, Wwf, Wwg, Ds^Es, Gs^Efm, Gg^Efm, Gg, Hh, Hh, Hh^Emf, Hh^Dr, Mm, Mm, Mm, Mm^Xm, Mm^Xm, Mm^Xm, Mm^Xm, Mm^Xm, Mm^Xm, Mm^Xm, Mm^Xm, Mm^Xm
Wwg, Wwg, Wwrg, Wwrg, Ds, Mm, Mm, Mm^Xm, Mm, Mm, Mm^Xm, Hh^Dr, Hh^Emf, Mm, Hh, Hh, Hh^Em, Mm, Wwf^Wkf, Wwf, Ds, Ds, Gs, Gs^Fds, Gs^Fds, Hh^Em, Hh^Emf, Hh^Emf, Hh^Fds, Mm, Mm, Mm^Xm, Mm^Xm, Mm^Xm, Mm, Mm^Xm, Mm^Xm, Mm^Xm, Mm^Xm, Mm^Xm
Wwf^Wkf, Wwf^Wkf, Ds^Ewsh, Wwrg, Ce^Edb, Ds^Es, Ds^Dr, Mm, Mm, Mm^Xm, Mm, Hh^Emf, Gd^Em, Gd^Fp, Gll^Fp, Hh, Mm, Hh, Wwf, Wwf, Gll^Fp, Gd, Gs^Es, Gs^Fds, Gs^Fds, Hh^Fds, Hh^Em, Hh^Fds, Hh, Mm, Mm, Mm, Mm^Qhh, Mm^Qhh, Mm^Qhh, Mm, Mm^Xm, Mm^Xm, Mm^Xm, Mm^Xm
Wwf^Wkf, Ds^Ewsh, Ds, Ce^Edb, 1 Ke, Ce, Ds, Mm, Hh, Mm, Hh, Hh^Fds, Gs, Gd^Fp, Hh^Vhh, Mm, Mm, Wwf^Dr, Wwg, Gd^Fp, Gll^Fp, Gs^Fms, Gs^Fds, Gs^Es, Hh^Fds, Hh^Fds, Hh, Mm, Mm, Hh^Dr, Mm, Mm^Qhh, Hh^Fms, Hh^Fms, Hh^Fds, Mm^Qhh, Mm^Qhh, Mm^Qhh, Mm^Qhh, Mm^Xm
Wwg, Wwf, Ds^Edb, Ce^Edb, Ce^Edb, Ce^Es, Gd^Edb, Ds^Edb, Gs, Gs, Gg, Gg, Gs^Es, Gs, Hh^Fp, Hh^Fp, Hh^Fp, Wwg, Wog, Gd^Fp, Gll^Efm, Gll, Gg, Gs^Vc, Hh, Hh, Mm^Xm, Mm^Xm, Mm^Xm, Mm^Xm, Mm^Qhh, Mm^Qhh, Hh^Fds, Gg^Fds, Gg^Fms, Hh^Dr, Gg^Fds, Hh^Fds, Mm^Qhh, Mm^Xm
Wwg, Wwf, Wwf^Wkf, Ds^Edb, Ds, Gd^Edb, Gd^Vct, Gs^Edb, Hh, Hh^Em, Mm, Gg, Gg, Gll^Em, Gll^Fp, Hh^Fp, Hh^Fp, Wog, Wog, Wwg, Wwf, Wwf, Ds, Hh, Mm, Mm, Mm, Mm^Xm, Mm^Xm, Mm^Xm, Mm^Qhh, Hh^Qhh, Hh^Qhh, Gg^Fds, Cfr, Gg, Gs^Efm, Hh^Fds, Mm^Qhh, Mm^Qhh
Wwrg, Wwrg, Ds^Ewsh, Ds, Gll^Fp, Gll^Ecf, Gd, Gd, Hh^Fds, Mm, Hh^Fds, Gg, Gs^Efm, Gll^Fp, Gg^Fms, Gs^Fds, Gll^Fp, Hh^Fp, Ds, Ds^Es, Wwf^Es, Wwf, Ds, Hh, Wwrg, Wwrg, Hh, Hh, Mm^Xm, Mm^Xm, Mm^Qhh, Hh^Dr, Gs, Cfr^Es, 3 Kfr, Cfr, Gs^Efm, Gs^Fet, Hh^Qhh, Mm^Qhh
Mm^Xm, Wwrg, Ds, Ds, Gd, Gll, Gd^Em, Gd^Es, Gs^Fds, Hh^Fds, Gg^Fds, Gg^Efm, Gs^Efm, Gs^Fms, Gs^Fds, Gs^Fms, Gll^Emf, Gd^Emf, Gs^Em, Ds^Es, Ds, Wwrg, Wwrg, Wwg, Wog, Wwg^Ewl, Wwg^Ewf, Hh^Fds, Mm, Mm^Xm, Mm, Mm^Qhh, Gs^Efm, Gs, Gg^Es, Gs^_mh, Gg^Fds, Gs^Es, Hh^Dr, Mm^Qhh
Mm^Xm, Mm^Xm, Mm^Xm, Mm^Xm, Gs, Gs^Es, Gs^Em, Gll^Fp, Gll^Fp, Gs^Fds, Gs^Fms, Gs^Fds, Gd, Gs, Gs, Gs^Fet, Gg^Fds, Gd^Ve, Gg, Ds, Ds, Wwrg, Ds, Wwg, Wog, Wog^Ewf, Wwg, Wog, Mm, Mm, Mm, Mm^Qhh, Hh^Qhh, Hh^Qhh, Gg^Qhh, Gg^Fds, Hh^Fms, Mm^Qhh, Mm^Qhh, Mm^Qhh
Mm, Mm, Hhd^Fds, Hhd, Hhd^Fds, Re, Gs, Gs^Fms, Gs^Fms, Gs^Fds, Gs^Fms, Gs^Fds, Gd, Gd^Efm, Gs^Fds, Gg, Gg^Efm, Gg^Efm, Re, Gg, Gs^Es, Ds, Ds^Es, Ds, Wwrg, Wog, Cfr^Eb, Hh, Hh, Gll^Fp, Gd^Vhhr, Mm, Hh, Hh^Qhh, Hh^Dr, Gs^Qhh, Hh^Qhh, Hh^Qhh, Mm^Qhh, Mm^Qhh
Hhd^Fp, Mm, Hhd^Em, Hhd^Fms, Gll^Fp, Re, Re, Gs^Fms, Gll^Fp, Gll^Fp, Hhd^Fp, Gd, Gd^Es, Gd, Gs, Gs^Fds, Gs, Gd, Re^Es, Gs, Wwf^Wkf, Wwf^Wkf, Gs, Gs^Fds, Hh^Fds, Wwg, Hh^Em, Hh^Fds, Gg^Fet, Gd^Efm, Re^Es, Gs^Es, Re, Hh, Gs, Hh^Fms, Hh^Fms, Hh^Qhh, Hh^Qhh, Mm^Qhh
Hhd^Fp, Hhd^Fp, Gll^Emf, Gd^Vhr, Gd^Em, Gd^Em, Rb, Gd, Gll^Es, Hhd, Hhd, Hhd, Gll, Gd, Gll, Gd^Efm, Gd^Efm, Gd, Gll, Re, Rb^Es, Wwf^Wkf, Re, Re, Re, Wwf^Bw/r, Gs^Es, Gs^Efm, Gg^Efm, Re, Hh^Em, Re^Es, Gg^Fds, Gs^Es, Gd, Hh^Fp, Hh^Qhh, Hh^Qhh, Mm^Qhh, Mm^Qhh
Gll^Fmw, Hhd^Fp, Gll^Fp, Gll^Fp, Gd, Gll^Fp, Gll^Es, Rb, Gll, Gll^Es, Gll, Gd, Gll^Es, Hhd, Hhd, Gd^Efm, Hhd, Gll^Efm, Rb, Rb, Hhd, Rb, Gd^Efm, Hhd^Fds, Wog^Qhu, Wwf, Wog^Qhu, Gs, Mm, Hh, Hh, Gg, Gg^Es, Gs, Hh, Gd^Es, Hh^Qhh, Hh^Qhh, Mm^Qhh, Mm^Qhh
Gll^Emf, Gll^Emf, Gll^Fmw, Gd^Fdw, Gd^Efm, Gd, Ds, Rb, Ds^Es, Ds, Wwf^Wkf, Gll^Fmw, Gll^Fdw, Hhd^Fdw, Hhd^Fdw, Hhd^Em, Hhd^Em, Gll^Fp, Rb, Gd^Efm, Hhd, Hhd^Fet, Hhd^Fms, Hhd^Fp, Wwrg^Qhu, Wog^Qhux, Wwg^Qhu, Mm^Qhu, Mm^Qhu, Mm, Mm^Xm, Mm^Xm, Mm^Xm, Hh, Gs^Qhh, Hh^Em, Mm^Qhh, Hh^Qhh, Mm^Xm, Mm
Ss, Gd^Emf, Ss, Gd^Em, Gll^Feth, Wwf^Wkf, Wwf^Wkf, Ds, Wwf, Ds, Wwf^Wkf, Gd^Fdw, Gd^Emf, Gd^Fdw, Hhd^Fetd, Hhd^Vc, Hhd, Rb, Gd, Gd, Gll, Hhd, Gd^Efm, Hhd^Fp, Gll, Wwg^Qhu, Wwg^Qhu, Wwf^Wkf, Wwf^Wkf, Mm^Qhu, Mm^Qhu, Mm^Xm, Mm^Qhh, Mm^Qhh, Mm^Qhh, Gg^Qhh, Mm^Qhh, Mm, Mm^Xm, Mm^Xm
Sm, Ss, Wwf, Ds, Ds, Ds^Es, Wwf, Wwf, Wwrg, Wwf^Wkf, Gll^Fdw, Gll^Emf, Rb^Em, Rb^Emf, Rb^Es, Rb, Rb^Es, Rb, Gll^Fp, Gd^Fp, Gll^Fp, Gll^Efm, Gd^Es, Gd^Es, Sm^Qhu, Wwf^Qhu, Wwf^_ml, Wwf^Es, Sm^Wkf, Wwf^Dr, Mm^Qhu, Mm^Qhh, Mm^Qhh, Hh^Fms, Gs^Es, Gg^Fms, Mm^Qhh, Mm, Mm, Mm
Sm, Wwf^Es, Wwf^Ewl, Wwg, Wog, Wwg, Ds^Es, Wwf^Es, Wwrg, Wwrg, Sm, Ss, Rb, Gd^Es, Hhd^Fmw, Gll^Fp, Gll^Em, Gll, Gll^Efm, Gll^Fp, Gd^Fp, Gll, Gd^Em, Gd^Es, Gll, Sm^Qhu, Wwf^Wkf, Wwf^Wkf, Sm^Qhu, Sm^Qhu, Mm^Xm, Mm^Qhh, Hh^Fds, Hh^Qhh, Gs^Fds, Gs^Fms, Mm^Qhh, Mm^Xm, Mm^Xm, Mm^Xm
Ss, Sm, Sm^Ewl, Wog^Ewf, Wog, Hhd^Fp, Ds, Ds, Wog, Wwg, Wwg, Sm, Rb^Em, Hhd, Hhd^Fmw, Hhd^Fmw, Gll, Gll^Efm, Gd^Em, Gll^Fp, Gd^Fp, Gd^Es, Gd^Fp, Gll^Fp, Gll^Fp, Ss^Qhu, Sm^Ewl, Wwf^Wkf, Mm^Qhu, Mm^Qhu, Mm^Xm, Mm^Qhh, Hh^Fds, Hh^Fds, Mm^Qhh, Mm^Qhh, Mm^Qhh, Mm^Xm, Mm^Qhh, Mm^Xm
Sm, Sm, Ss, Ss, Wwf^Wkf, Wwg^Wkf, Wwf^Es, Wwf^Es, Wwf, Wwg^Ewl, Wwf^Bw/r, Rb^Emf, Gd^Fdw, Ss, Ss, Ss, Gll^Fdw, Gll^Es, Gd^Emf, Gd, Gd^Emf, Gd^Es, Gll^Fp, Hhd^Fp, Hhd^Fp, Sm^Qhu, Sm^Ewl, Sm^Ewl, Mm^Qhu, Mm^Qhu, Mm^Xm, Mm^Xm, Mm^Qhh, Hh^Fds, Hh^Fds, Mm^Qhh, Gs^_mh, Mm^Qhh, Hh^Fds, Mm^Qhh
Hhd, Sm, Ss, Ss, Ss, Wwf^Wkf, Sm^Ewl, Wwf^Es, Ds, Wwg^Bw/r, Wwf^Wkf, Gll^Fdw, Gll^Fmw, Ss, Hhd^Fp, Gll, Gd^Es, Gd^Fmw, Gd^Em, Gll^Em, Gll^Emf, Gll, Hhd, Hhd^Fp, Ss^Qhu, Sm^Qhu, Ss^Qhu, Sm^Qhu, Mm^Qhu, Mm^Xm, Mm^Xm, Mm, Mm^Qhh, Mm^Qhh, Hh^Qhh, Gg^Fds, Gs^Efm, Gs^Fet, Hh^Fds, Hh^Fds
Hhd^Fdw, Hhd^Fmw, Gd^Fp, Ss, Sm, Sm^Ewl, Chr^Fmw, 2 Khr^Fdw, Chr^Emf, Hhd^Vhcr, Ss, Ss, Sm, Sm, Hhd^Fmw, Gll^Fp, Gll^Fdw, Gd^Emf, Gd^Emf, Gll, Gll^Fp, Gll^Fp, Hhd^Em, Hhd, Ss^Qhu, Ss^Qhu, Ss^Qhu, Sm^Qhu, Ss^Qhu, Mm^Qhu, Mm, Mm, Mm^Xm, Mm^Xm, Hh^Dr, Gg^Efm, Gg^Efm, Hh^Em, Hh^Fds, Hh^Fds
Gll^Es, Gll^Emf, Gd^Emf, Ss, Sm, Sm, Sm, Chr^Em, Wwg^Dr, Hhd^Fetd, Ss, Sm, Sm, Hhd^Fdw, Hhd^Fp, Hhd^Fmw, Hhd^Fdw, Gd^Emf, Gll^Es, Gd^Em, Gll^Fp, Hhd, Hhd, Ss^Qhu, Ss^Qhu, Ss^Qhu, Ss^Qhu, Ss^Qhu, Mm^Qhu, Mm^Qhu, Mm^Xm, Mm, Mm, Mm^Xm, Mm, Hh^Qhh, Mm^Qhh, Mm, Mm, Hh^Fds
Gll^Fmw, Gd^Em, Gll^Fmw, Hhd^Fmw, Ds, Ss, Ss, Wwf^Es, Wwf, Wwf, Ss, Ss, Ss, Ss, Ss, Ss, Hhd^Fdw, Gll^Fp, Gll^Fp, Gll^Fp, Gll^Fp, Hhd^Fp, Ss, Ss^Qhu, Ss^Qhu, Ss^Qhu, Gg^Qhu, Ss^Qhu, Mm^Qhu, Mm^Xm, Mm^Xm, Mm^Xm, Mm, Mm, Mm, Mm, Mm^Xm, Mm^Xm, Mm, Mm
