Ww, Ww, Ww, Ds, Ds, Gs, Gs^Ft, Gs^Ft, Gs^Ft, Gs^Ft, Rd, Rd, Re, Re, Re, Re, Gg, Gg, Ww, Ww, Ds, Re, Gg, Gg, Gg, Hh, Hhd, Gg, Gs^Fms, Gs^Fp, Gs^Fp, Ss, Ss, Ss, Ss, Ss, Sm, Ss, Ss, Ss
Ww, Ww, Ds, Ds, Gs, Gd, Gs^Ft, Gs^Ft, Gll^Ftr, Gs^Ft, Re, Re, Rd, Re, Gg, Gg, Gs, Gg, Gs, Ww, Ds, Re, Gg, Gg^Edt, Gs, Hh, Hhd, Gll^Ftr, Gs^Fms, Gs^Fp, Gs^Fms, Gs^Fp, Ss, Ss, Ss, Ss, Sm, Ss, Ss, Ss
Ww, Ww, Ds, Gg, Chr, Gs^Ft, Rd^Edt, Rd, Re, Re, Gs, Gs, Gg, Gg, Gg, Gg, Ds, Gs, Ds, Ds, Ds, Re, Rd, Gd, Gs, Hh^Em, Hhd, Hh, Hh, Gs^Fms, Gs^Fp, Gs^Fp, Ss, Ss, Ss, Ss, Sm, Gll^Ftr, Gll^Ftr, Ss
Ds, Ds, Gd, Chr, 1 Khr, Chr^Edt, Re, Re, Gs^Vht, Re, Re, Gs^Ft, Gs, Gs, Gg, Ds, Ds, Ww, Ww, Gg, Gg, Re, Rd, Gs, Hh, Hh, Hhd, Mm, Mm, Hh, Gs^Fp, Ss, Ss, Ss, Ss, Ss, Ss, Sm, Sm, Gll^Ftr
Ds, Ds, Gs^Ft, Chr^Edt, Chr^Edt, Chr, Re, Gd, Gd, Gs, Gs, Re, Re, Gd, Gd, Gg, Ds, Ds, Ww, Gs, Gd^Vh, Re, Gs, Gs, Hh, Hhd^Dr, Mm^Xm, Mm, Mm, Mm, Mm, Ss, Gs^Fp, Ss^Vhs, Ss, Ss, Ss, Ss, Sm, Gll^Ftr
Ds, Gll^Ftr, Gs^Ft, Chr, Chr, Chr, Re, Rp^Vhcr, Gd, Gs, Gs, Gg^Efm, Gs, Re, Re, Gd^Edt, Gg, Ds, Ww, Ds, Ds, Re, Gs, Hh, Mm, Mm, Mm, Mm, Mm, Mm, Mm, Gll^Ftr, Gll^Ftr, Ss, Chr, Sm, Ss, Sm, Sm, Sm
Ds, Gll^Ftr, Gs, Gd, Gd, Gd^Ecf, Re, Gs, Gs, Gs, Gs^Ft, Gs, Gs, Ds, Re, Gd, Gd, Gg, Gd, Ds, Gd, Re, Gs, Hh, Wwr, Wwr, Ww, Ww, Mm, Mm^Xm, Mm, Mm, Sm, Chr, 3 Khr, Chr, Sm, Sm, Gll^Ftr, Sm
Gd, Gll^Ftr, Gs^Vht, Gg, Rr, Re, Gd^Em, Gd, Gs^Ft, Gs, Gs, Gs, Ds, Ds, Re, Gs, Re, Gd, Gd, Gd, Gd^Edt, Re, Gs, Ww, Ww, Ww, Ww^Bw/r, Ww^Bw/r, Mm, Mm, Hh^Vud, Mm, Mm, Sm, Wwr, Sm, Ss, Ss, Ss, Sm
Gs, Gs, Rr, Rr, Re, Re^Es, Gd^Em, Gs^Ft, Gs^Ft, Ds, Gd, Gg, Ds, Ww, Ds, Re, Ds, Re, Re, Rd, Re, Re^Es, Re, Ds, Ww^Bw/r, Ww^Bw/r, Ww, Ww, Mm, Mm, Hh^Dr, Mm, Hhd^Em, Sm, Wwr, Ss, Ss, Ss, Ss, Ss
Rr, Rr, Re, Re, Gd, Re, Gs, Gg, Gg, Gs, Gd^Edt, Gg, Gg, Gg, Gs, Gs, Ds, Gg, Gg, Re, Gs, Re, Re, Ww^Bw/r, Ww, Ww, Hhd, Hh^Dr, Hh, Gd, Gd, Hh, Ww, Ww, Ds, Ss, Gll^Ftr, Ss, Ss, Ss
Rr, Re, Gs^Ft, Gll^Ftr, Gg, Re, Re, Gs^Ft, Gg, Gs, Gs, Gg, Gs, Gg, Gg^Vhhr, Ds, Gs, Gd, Gd, Re, Gs, Gs, Gd^Vo, Re, Re, Ww, Hh^Em, Hh, Gg, Gg, Gd, Gs, Wwr, Ds, Gs, Gs^Fms, Gs^Fms, Ss, Gg^Efm, Ss
Re, Re, Gs^Ft, Gs^Vht, Gg, Gs, Re, Gs, Gg, Gs, Gs, Ds, Gs, Gg, Gs, Gs, Gs, Gd, Gd, Re, Gd, Gs, Gs, Gg, Hh, Ww^Bw\r, Re, Gs, Gs, Ds, Ww, Ww, Re, Re^Es, Re, Gs^Fp, Re, Gs^Fp, Gg, Gg
Gs^Ft, Gs^Ft, Gs^Ft, Gg, Ss, Gll^Ftr, Gg^Efm, Re, Gg, Gs, Gs^Em, Gs, Gg, Gg, Gg, Gs^Edt, Gs^Edt, Gd^Dr, Re, Re, Gd, Gs, Gs, Gg, Ww, Ww, Gd^Vo, Re, Re, Re, Re, Re, Gs^Dr, Gd, Gs, Re, Rr, Re, Re, Re
Ds, Ds, Gll^Ftr, Ss, Gs^Ft, Gll^Ftr, Re, Re^Efm, Re, Ss, Sm, Gd, Gg, Gs^Ft, Gd, Gg^Edt, Gg^Edt, Re, Gd, Gd, Gd, Gs^Edt, Gs^Edt, Gg^Edt, Gs, Ww, Ds, Gg, Gg, Rr, Gs, Gd, Gs, Gs, Gs, Gs, Gs, Rr, Rr, Rr
Ss, Ds, Ss, Ss, Gs^Ft, Ss, Ww^Bw|r, Ds, Ds, Ss, Sm, Ds, Ds, Gs^Ft, Ds, Gd, Re, Re^Es, Gs^Edt, Gs, Gs, Gs^Edt, Gs, Gs, Gs, Wwr, Ds, Gg, Gs^Fms, Gs, Gd, Gs^Edt, Gd, Gs, Gd, Gs, Gd, Gs, Gs^Fp, Hh
Ww, Ss, Wwr, Ds, Ds, Ds, Ww^Bw|r, Wwr, Ss, Ss, Gll^Ftr, Ds, Sm, Ds, Ds, Gd, Gd, Rd, Gs, Gs, Gs, Gs, Gs, Gs, Wwr, Ss, Ss, Gg, Gs^Fp, Gs^Ft, Gd^Es, Gd, Gd^Edt, Rd, Hhd, Gd, Gs, Hh, Mm, Hh
Ww, Ww, Ww, Ww, Ww, Ww, Ww^Bw|r, Wwr, Wwr, Ss, Ss, Sm, Ds^Edt, Ds, Rd, Gd, Ds, Rd, Rd, Gs^Fp, Gll^Ftr, Gs, Gs, Gs, Gs, Ss, Gs^Ft, Gg, Gs^Efm, Gd, Gg, Gg, Rd, Rd, Gs^Fms, Gs^Fms, Hh, Mm, Mm, Hh
Ss, Ww, Sm, Ww, Ww, Ww, Ww^Bw|r, Ww, Ww, Ds, Ds, Ss, Ds, Ds^Em, Gg, Gd, Ds, Ds, Rd, Gs^Ft, Gs^Fp, Gs, Gs^Fp, Gs^Fp, Gs^Fp, Ss, Gs, Gs, Gs, Gd, Gg, Gs^Vl, Hh, Gs^Fp, Hh, Gs^Fms, Gs^Fds, Mm, Gs^Ft, Gs
Ss, Sm, Gs^Ft, Ss, Sm, Wwr, Ww^Bw|r, Ww, Ww, Ww^Ewl, Wwr, Ds, Gs^Ft, Ss, Ss, Ss, Gll^Ftr, Ds, Gs, Gs, Gs, Gs, Gs^Fp, Hh, Gg^Fet, Ss, Ss, Ss, Gs, Gd, Gs^Fds, Hh^Em, Hh^Fp, Hh, Gs, Hh^Fp, Gs^Fds, Mm, Gs, Gs
Ss, Gs^Ft, Ds, Ds, Ss^Edt, Sm, Ss^Vhs, Ss, Ss, Ww, Ww, Ds, Gs^Ft, Ss, Gll^Ftr, Gs, Gs, Gs^Ft, Gs, Gs, Gd^Edt, Gd, Hh, Hh^Em, Gs^Ft, Ss, Gs^Ft, Ss, Gg, Gg^Fet, Hh, Hh, Gs^Fms, Hh, Gs, Hh^Fp, Hh, Mm, Hh, Hh^Em
Ds, Ds, Ds, Ss, Ss, Sm, Chr, 2 Khr, Chr, Ww^Edt, Ww, Ww, Wwr, Sm, Gs^Ft, Gll^Ftr, Gs, Gs, Gs, Gd, Gs^Fp, Gs^Fp, Hh^Em, Hh^Em, Gs^Ft, Ss, Ss, Ss, Gs^Ft, Gs^Fms, Hh^Fp, Gs^Fms, Gs^Fms, Gg, Hh, Hhd^Em, Hh^Fp, Hh^Fp, Gs^Fms, Gs^Fp
Gs^Ft, Gs^Ft, Ds, Ss, Ss, Ss, Ss, Chr, Ss, Ds, Ds, Ww, Ww, Gs^Ft, Gs^Ft, Gll^Ftr, Gll^Ftr, Gs, Gs, Gd, Gs^Fp, Hh, Hh, Gs^Ft, Ss, Ss, Gs^Ft, Gs^Ft, Hhd^Em, Hh, Gs^Fms, Hh, Gs, Hh^Fp, Hh^Fp, Gs^Efm, Gs^Fp, Gs^Fms, Gs^Fms, Gs^Fms
Ds, Gs^Ft, Gs^Ft, Ds, Ds, Ss, Ss, Ss, Ss, Ss, Ss, Ww, Ww, Ww, Ss, Ss, Gs^Ft, Gll^Ftr, Gs^Fp, Gs^Fp, Gs^Fp, Gs^Fp, Ss, Ss, Ss, Ss, Gg, Gs^Ft, Hh, Gs^Fp, Gs^Fp, Gs^Fp, Hh^Fp, Hh^Fp, Gs, Gg, Gs^Fp, Gs^Fms, Gs^Fp, Gs^Fp
