Ww, Ww, Ww, Ds, Ds, Gg, Gs^Ft, Gs^Ft, Gs^Ft, Gs^Ft, Rd, Rd, Re, Re, Gg, Gg, Gg, Gs, Ds, Ds, Ds, Gg, Gg, Hh, Hh, Hh, Hh, Gs^Fp, Gg^Fms, Gs^Fp, Gs^Fp, Ss, Ss, Ss, Ss, Ss, Ss, Ss, Ss, Ss
Ww, Ww, Ds, Ds, Gg, Gg, Gs^Ft, Gs^Ft, Gs^Ft, Gs^Ft, Re, Re, Gg, Gg, Gg, Gg, Gg, Gs, Gd, Ds, Ds, Gs, Gg, Gg, Gs, Hh, Hh, Gs^Fp, Gg^Fms, Gs^Fp, Gg^Fms, Gs^Fp, Ss, Ss, Ss, Ss, Ss, Ss, Ss, Ss
Ww, Ww, Ds, Gg, Chr, Gs^Ft, Rd, Rd, Re, Re, Gs, Gs, Gd, Gg, Gg, Gg, Ds, Gg, Gg, Gs, Gs, Gs, Gg, Gg, Gd^Em, Hh^Em, Hh, Hh, Hh, Gg^Fms, Gs^Fp, Gs^Fp, Ss, Ss, Ss, Ss, Ss, Ss, Ss, Ss
Ds, Ds, Gs, Chr, 1 Khr, Chr, Re, Re, Gs^Vht, Re, Re, Gs^Ft, Gs^Ft, Gs^Ft, Gg, Ds, Ds, Gg, Gg, Gg^Efm, Gg^Efm, Gg^Efm, Gg, Gs, Hh^Em, Hh^Emf, Hh, Mm, Mm, Hh, Gs^Fp, Ss, Ss, Ss, Ss, Ss, Ss, Ss, Ss, Ss
Ds, Ds, Gs^Ft, Chr, Chr, Chr, Re, Gs, Gg, Gg, Gs^Ft, Re, Re, Gg, Gg, Gg, Ds, Ds, Gg, Gg, Gs, Gg, Gg, Gs, Hh, Hh, Mm^Xm, Hh^Vhh, Mm, Mm, Mm, Ss, Gs^Fp, Ss^Vhs, Ss, Ss, Ss, Ss, Ss, Ss
Ds, Gs^Ft, Gs^Ft, Chr^Edb, Chr^Edb, Chr^Edb, Re, Gs^Vht, Gg, Gg, Gs^Ft, Gs^Ft, Gs, Re, Re, Gg, Gg, Ds, Gg, Ds, Ds, Gs, Gg, Hh, Mm, Mm, Mm, Mm, Mm, Mm, Mm, Ss, Ss, Gs^Fp, Ss, Ss, Ss, Ss, Ss, Ss
Ds, Gs^Ft, Gs, Gd^Edb, Gs^Edb, Gs^Edb, Re, Gg, Gg, Gs^Ft, Gs^Ft, Gs, Gg, Ds, Re^Es, Gg, Gd, Gg, Gg, Ds, Gs, Gs, Gg, Hh, Wwr, Ww, Ww^Wkf, Ww^Wkf, Mm, Mm^Xm, Mm^Xm, Mm, Hh, Gs^Fp, Ss, Ss, Ss, Ss, Ss, Ss
Gs, Gs^Ft, Gs^Vht, Gs, Re, Re, Gs, Gg, Gs^Ft, Gs, Gs, Gs, Ds, Ds, Re^Es, Gs, Re, Gs, Gs^Ecf, Gs, Gg, Gg^Efm, Gg, Wwr, Ww, Ww, Ww^Bw/r, Ww^Bw/r, Mm, Mm, Mm, Mm, Mm, Hh, Gg, Ss, Ss, Ss, Ss, Ss
Gg, Gg, Re, Re, Rd, Rd, Gs, Gs^Ft, Gs^Ft, Ds, Gg, Gg, Ds, Gg, Ds, Re, Ds, Re, Re, Re, Re, Gg, Gg, Wwr, Ww^Bw/r, Ww^Bw/r, Wwr, Wwr, Mm, Mm, Mm, Mm, Hh^Emf, Hh, Gg, Ss, Ss, Ss, Ss, Ss
Re, Re, Rd^Es, Rd, Gs, Gs, Gg, Gg, Gs, Gg, Gg, Gg, Gg, Gg, Gg, Gg, Gs, Gs, Gs, Gs, Gs, Re, Re, Ww^Bw/r, Ww, Ww^Wkf, Hh^Em, Hh^Emf, Hh^Em, Hh^Vhh, Hh^Fp, Hh^Em, Gd^Em, Gg, Gg, Ss, Ss, Ss, Ss, Ss
Rd, Rd^Es, Gs^Ft, Gs^Ft, Gg, Gg, Gs, Gs^Ft, Gs, Gg^Efm, Gg, Ds, Gg, Gs, Gs, Ds, Gg, Ds, Ds, Ds, Gs, Gg, Gg^Vh, Re, Re, Ww, Hh, Hh^Em, Gg, Gs, Gs^Fp, Gg^Fms, Gs, Gg, Gg, Gg^Fms, Gg^Fms, Ss, Gs, Ss
Gg, Gg, Gs^Ft, Gg^Vht, Gg, Gg, Gg, Gs, Gg, Gg, Gg, Ds, Gg, Ds, Ds, Ds, Gg, Ds, Ds, Ds, Ds, Ds, Gg, Gg, Hh, Ww^Bw\r, Re, Gs^Fp, Gs^Fp, Gg, Gs, Gs, Re, Re, Re, Gs^Fp, Re^Es, Gs^Fp, Gg, Gg
Gs^Ft, Gs^Ft, Gs^Ft, Gg, Ss, Gs^Ft, Gg, Gg, Gg, Ss, Gg, Gg, Gs, Gs, Gs, Gg, Gg, Gg, Ds, Ds, Gg, Gg, Gg, Gg, Wwr, Ww, Gg^Vh, Re, Re, Re, Re, Re, Gs^Fp, Gg, Gg, Re^Es, Gs, Re^Es, Re, Re
Ds, Ds, Gs^Ft, Ss, Gs^Ft, Gs^Ft, Gg, Gg, Gg, Ss, Ss, Gg, Gs, Gs^Ft, Gs^Ft, Gs, Gs, Gg, Gg, Ds, Gg, Ds, Gg, Gs, Gs, Ww^Wkf, Ss, Gg, Gs, Gs, Gs, Gg, Gg, Gg, Gg, Gs^Fp, Gs^Fp, Gs, Gs, Gd
Ss, Ds, Ss, Ss, Gs^Ft, Ss, Ww^Bw|r, Ds, Ds, Ss, Ss, Ds, Ds, Gs^Ft, Ds, Gs^Ft, Gd, Gg, Gg^Efm, Gg, Gg, Gg, Ds, Gg, Gs, Ww^Wkf, Ss, Gg, Gg^Fms, Gs^Fp, Gd, Gg, Gg^Efm, Gg, Gg, Gs^Fp, Gg, Gg, Gs^Fp, Hh
Ww, Ss, Ss, Ds, Ds, Ds, Ww^Bw|r, Wwr, Ss, Ss, Ss, Ds, Ss, Ds, Ds, Gs^Ft, Gs^Ft, Gs, Gg, Gg, Gg, Ds, Ds, Gg, Gg, Ss, Ss, Gg, Gs^Fp, Gg^Fms, Gs, Gg^Efm, Gg^Efm, Gs, Hh, Gg, Gg, Hh, Gg^Fms, Hh
Ww^Wkf, Ww^Ewf, Ww, Ww^Ewl, Ww^Ewl, Wwr, Ww^Bw|r, Wwr, Ss, Ss, Ss, Ss, Ds, Ds, Gg, Gs^Ft, Ds, Gs, Gg, Gs^Ft, Gs^Ft, Gg, Gg, Gg, Gg, Ss, Ss, Gg, Gs, Gs, Gg, Gg, Gs, Gs, Gg^Fms, Gg^Fms, Hh, Gg^Fms, Gg^Fms, Hh
Ss, Ww^Wkf, Ss, Ww, Ww^Wkf, Ww, Wo^Bw|r, Ww^Wkf, Ww^Wkf, Ds, Ds, Ss, Ds, Ds, Gg, Gg^Vh, Ds, Ds, Gs, Gs^Ft, Gs^Ft, Gs, Gs^Fp, Gs^Fp, Gs^Fp, Ss, Gg, Gg, Gg, Gg, Gg, Gs^Vh, Hh, Gs^Fp, Hh, Gg^Fms, Gg^Fds, Gg^Fms, Gs^Fp, Gg
Ss, Ss, Gs^Ft, Ds, Ss, Ww^Wkf, Ww^Bw|r, Ww, Wwr, Ww, Ww, Ds, Gs^Ft, Ss, Ss, Ss, Gs^Ft, Ds, Gg, Gs, Gs, Gs, Gs^Fp, Gg^Fms, Gg, Ss, Ss, Ss, Gg, Gg, Gg^Fds, Hh, Hh^Fp, Hh, Gs, Hh^Fp, Gg^Fds, Gg^Fet, Gs, Gg
Ss, Gs^Ft, Ds, Ds, Ss, Sm, Ss^Vhs, Sm, Sm, Ww, Ww^Ewl, Ds, Gs^Ft, Ss, Gs^Ft, Gs, Gs, Gs^Ft, Gg, Gg, Gg, Gg, Gg^Fms, Gg^Fms, Gs^Fp, Ss, Gs^Fp, Ss, Gg, Gg^Fds, Hh, Hh, Gg^Fms, Hh, Gs, Hh^Fp, Hh, Gg^Fms, Hh, Hh
Ds, Ds, Ds, Ss, Ss, Ss, Chs, 2 Khs, Chs, Ww^Wkf, Ww, Ww^Ewl, Ww^Ewf, Ss, Gs^Ft, Gs^Ft, Gd, Gg, Gg^Efm, Gg, Gs^Fp, Gs^Fp, Gg^Fms, Gg^Fms, Gs^Fp, Ss, Ss, Ss, Ss, Gg^Fms, Hh^Fp, Gg^Fms, Gg^Fms, Gd, Hh, Hh, Hh^Fp, Hh^Fp, Gg^Fms, Gs^Fp
Gs^Ft, Gs^Ft, Ds, Ss, Ss, Ss, Ss, Chs, Ss, Ds, Ds, Ww, Ww^Ewl, Gs^Ft, Gs^Ft, Gs^Ft, Gs^Ft, Gs, Gs, Gg, Gs^Fp, Gg^Fms, Gg^Fms, Gs^Fp, Ss, Ss, Gs^Fp, Ss, Hh, Hh, Gg^Fms, Hh, Gs, Hh^Fp, Hh^Fp, Gs, Gs^Fp, Gg^Fms, Gg^Fms, Gg^Fms
Gs^Ft, Gs^Ft, Gs^Ft, Ds, Ds, Ss, Ss, Ss, Ss, Ss, Ss, Ww^Wkf, Ww^Wkf, Ww, Ss, Ss, Gs^Ft, Gs^Ft, Gs^Fp, Gs^Fp, Gs^Fp, Gs^Fp, Ss, Ss, Ss, Ss, Ss, Ss, Hh, Gs^Fp, Gs^Fp, Gs^Fp, Hh^Fp, Hh^Fp, Gg, Gs, Gs^Fp, Gg^Fms, Gs^Fp, Gs^Fp
