Wo, Ww, Ww, Ds, Ds, Gs, Gs^Ft, Gs^Ft, Gs^Ft, Gs^Ft, Rd, Rd, Re, Re, Rb, Re, Gd, Gs, Ds, Ds, Ds, Gg, Gs, Hhd, Hhd, Hhd, Hh, Gg, Gs^Fms, Gs^Ft, Gs^Ft, Ss, Ss, Ss, Ss, Ss, Sm, Ss, Ss, Ss
Wo, Ww, Ds, Ds^Ewsh, Gg^Edb, Gs^Edb, Gs^Ft, Gs^Ft, Gs^Ft, Gs^Ft, Re, Re, Rb^Es, Rb, Gd, Gd, Gs, Gs, Gg, Ds^Ewsh, Ds, Gg, Gs, Gs, Gs, Hh, Hh, Hh^Fp, Hhd^Fms, Gs^Ft, Gs^Fms, Gs^Ft, Ss, Ss, Ss, Ss, Sm, Ss, Ss, Ss
Ww, Wwr, Ds^Ewsh, Gd, Chr, Gs^Ft, Rd, Rd, Re, Re, Gs, Gs, Gs, Gs, Gs, Gs, Ds, Gs, Gs^Edb, Gd^Edb, Ds, Gs, Gg, Gg, Gs^Edb, Hh, Hh^Dr, Hhd, Hhd, Gs^Fp, Gs^Ft, Gs^Ft, Ss, Ss, Ss, Ss, Ss, Sm, Ss, Ss
Ds, Ds, Gs, Chr, 1 Khr, Chr, Re, Re^Es, Gs^Vht, Re, Re, Gs^Ft, Gs^Ft, Gs^Ft, Gs, Ds, Ds, Gg, Gg, Gd, Gd^Edb, Gg, Gg^Efm, Gg, Hhd^Em, Hhd^Em, Hh^Dr, Mm, Mm, Hhd, Gs^Ft, Ss, Ss, Ss, Ss, Sm, Ss, Sm, Sm, Ss
Ds, Ds^Esd, Gs^Ft, Chr, Chr, Chr, Re, Gd^Edb, Gs^Edb, Gg, Gs^Ft, Re, Re, Gg, Gg, Gs, Ds^Esd, Ds, Gg, Gs, Gs, Gg, Gs^Edb, Gs, Hhd^Em, Hh^Dr, Mm^Xm, Hh^Vhh, Mm, Mm^Xm, Md, Ss, Gs^Ft, Ss^Vhs, Ss, Ss, Ss, Ss, Ss, Ss
Ds, Gs^Ft, Gs^Ft, Chr, Chr^Edb, Chr, Re^Es, Gs^Vht, Gs, Gg, Gs^Ft, Gs^Ft, Gs, Rb, Rb, Gg^Edb, Gs^Edb, Ds^Esd, Gg, Ds, Ds, Gg, Gs^Edb, Hh, Md, Mm, Mm, Mm, Md, Mm, Mm, Ss, Ss, Gs^Ft, Ss, Ss, Ss, Ss, Ss, Ss
Ds, Gs^Ft, Gs, Gs, Gd^Edb, Gs^Edb, Re, Gd, Gs^Edb, Gs^Ft, Gs^Ft, Gg, Gd, Ds, Rb, Gg, Gg, Gs^Edb, Gg, Ds, Gg, Gg, Gll, Hhd, Ww^Ewl, Ww^Ewl, Ww, Wwr, Mm, Mm, Mm, Md, Hhd, Gs^Ft, Ss, Ss, Ss, Ss, Ss, Sm
Gs, Gs^Ft, Gs^Vht, Gs, Rb^Es, Re, Gd, Gd, Gs^Ft, Gs, Gs, Gd, Ds, Ds, Re^Es, Gg^Efm, Re, Gg, Gs, Gs, Gs, Gs^Efm, Gll, Ww^Ewl, Wwr, Ww^Ewl, Ww^Bw/, Ww^Bw/, Md, Mm^Xm, Mm, Mm, Mm, Hhd, Gs, Ss, Ss, Ss, Ss, Ss
Gg, Gg, Rb, Rb^Es, Re, Re, Gs, Gs^Ft, Gs^Ft, Ds, Gs, Gd^Edb, Ds, Gs^Edb, Ds^Esd, Re^Es, Ds, Re, Re, Re, Rb, Gll, Re^Es, Ww, Ww^Bw/, Ww^Bw/, Wo, Ww, Md, Md, Md, Mm, Hh^Em, Hhd^Em, Gs^Edb, Ss, Ss, Ss, Ss, Ss
Rb, Rb, Re, Re, Gg, Rr, Gs^Edb, Gg, Gg^Efm, Gg, Gs, Gs, Gs, Gs, Gs^Edb, Ds^Esd, Gd, Gd, Gs, Gg, Gs, Rb, Re, Ww^Bw/, Ww, Ww^Ewf, Hh, Hh^Dr, Hh^Em, Hh^Ve, Gs^Fp, Hh, Gll, Gd^Edb, Gg, Ss, Ss, Ss, Ss, Ss
Re, Re^Es, Gs^Ft, Gg^Ft, Gs, Gs^Edb, Gs^Edb, Gs^Ft, Gg, Gg, Gs, Ds, Gg, Gg, Gg^Vh, Ds, Gd, Ds, Ds^Esd, Ds^Esd, Gd, Gs^Edb, Gg^Vh, Re, Re, Ww, Hhd, Hhd^Em, Gg, Gd, Gs^Fp, Gs^Fms, Gg, Gg^Edb, Gg^Efm, Gs^Fms, Gs^Fms, Ss, Gg, Ss
Re, Re, Gs^Ft, Gs^Vht, Gs, Gd, Gd, Gs, Gs, Gs, Gs, Ds, Gs, Ds, Gs, Gs, Gs, Ds, Ds, Ds^Esd, Ds, Ds, Gd, Gg, Hh, Ww^Bw\, Rb, Gs^Fp, Gs^Fp, Gg, Gg, Gg, Re, Re^Es, Re, Gs^Fp, Rb, Gs^Fp, Gs^Edb, Gs^Edb
Gs^Ft, Gs^Ft, Gs^Ft, Gs, Ss, Gs^Ft, Gd, Gg, Gll, Ds, Gll, Gs, Gs^Edb, Gs^Edb, Gll^Edb, Gs, Gs, Ds, Ds, Ds, Ds^Ewsh, Re, Gll, Gg, Wwr, Ww, Gs^Vh, Re, Re, Re, Re^Es, Rb, Gs^Vc, Gs, Gd, Rb, Gll, Rb, Rb^Es, Rb
Ds, Ds, Gs^Ft, Ss, Gs^Ft, Gs^Ft, Gd, Gd, Gd, Ss, Ss, Gd, Gd, Gs^Ft, Gs^Ft, Gll, Gd, Ds^Esd, Ds^Esd, Ds, Ds, Re^Es, Gs, Gg, Gs, Wwr, Ss, Gs, Gg, Gd, Gll, Gs, Gs^Edb, Gg, Gs^Efm, Gs^Fp, Gs^Fp, Gs, Gg, Gg
Ss, Ds, Ss, Ss, Gs^Ft, Ss, Ww^Bw|r, Ds, Ds, Ss, Sm, Ds, Ds, Gs^Ft, Ds, Gs^Ft, Gd, Gs, Gs^Esd, Re, Re, Re^Es, Gg, Gll, Gs, Ww, Ss, Gs, Gs^Fp, Gs^Fp, Gg, Gll^Edb, Gs, Gg^Edb, Gg, Gs^Fp, Gg, Gs, Gs^Fp, Hh
Ww, Ss, Ss, Ds, Ds, Ds, Ww^Bw|r, Wwr, Ss, Ss, Ss, Ds, Ss, Ds, Ds, Gs^Ft, Gs^Ft, Gd, Gs, Gs, Gs, Ds, Gg, Gg^Edb, Gs^Edb, Ss, Ss, Gs^Edb, Gs^Fp, Gs^Fms, Gg, Gd, Gg, Gs, Hh, Gs, Gs^Edb, Hhd, Hhd^Fms, Hhd
Ww, Wwr, Ww, Ww, Ww^Ewl, Ww^Ewl, Ww^Bw|r, Wwr, Sm, Sm, Sm, Ss, Ds, Ds, Gs, Gs^Ft, Ds, Gd, Gs, Gs^Ft, Gs^Ft, Gg, Gg^Efm, Gd, Gs, Ss, Ss, Gs^Edb, Gg^Edb, Gs^Efm, Gg, Gg, Gs, Gll, Gs^Fms, Gs^Fms, Hh, Gs^Fms, Gs^Fms, Hh
Ss, Ww, Ss, Wo, Ww, Ww, Ww^Bw|r, Ww, Wo, Ds, Ds, Ss, Ds, Ds, Gg, Gg^Vh, Ds, Ds, Gs, Gs^Ft, Gs^Ft, Gg, Gs^Fp, Gs^Fp, Gs^Fp, Ss, Gd, Gd, Gd, Gs, Gs, Gg^Ve, Hhd, Gs^Fp, Hh, Gs^Fms, Gs^Fds, Gs^Fms, Gs^Fp, Md
Ss, Ss, Gs^Ft, Ds, Ss, Wwr, Ww^Bw|r, Ww, Ww, Ww^Ewl, Ww^Ewl, Ds, Gs^Ft, Ss, Ss, Ss, Gs^Ft, Ds, Gg, Gg, Gg, Gg, Gs^Fp, Gs^Fms, Gs, Ss, Ss, Ss, Gs, Gll^Edb, Gs^Fds, Hh, Hh^Fp, Hhd, Gll, Hh^Fp, Gs^Fds, Gs^Fms, Md, Md
Ss, Gs^Ft, Ds, Ds, Ss, Sm, Ss^Vhs, Sm, Sm, Ww, Ww^Ewl, Ds, Gs^Ft, Ss, Gs^Ft, Gs, Gs^Edb, Gs^Ft, Gg, Gg^Efm, Gs, Gd, Gs^Fms, Gs^Fms, Gs^Fp, Ss, Gs^Fp, Ss, Gg, Gs^Fds, Hh, Hh, Gs^Fms, Hhd, Gs, Hhd^Fp, Hh, Gs^Fms, Hhd, Hhd
Ds, Ds, Ds, Ss, Sm, Sm, Sm, 2 Khs, Ss, Wo, Wo, Ww, Wwr, Ss, Gs^Ft, Gs^Ft, Gs, Gg, Gd^Edb, Gd^Edb, Gs^Fp, Gs^Fp, Gs^Fms, Gs^Fms, Gs^Fp, Ss, Ss, Ss, Ss, Gs^Fms, Hhd^Fp, Gs^Fms, Gs^Fms, Gs^Efm, Hh, Hh, Hh^Fp, Hhd, Hh^Fms, Hh^Fp
Gs^Ft, Gs^Ft, Ds, Ss, Ss, Ss, Sm, Chs, Ss, Ds, Ds, Ww, Ww, Gs^Ft, Gs^Ft, Gs^Ft, Gs^Ft, Gd, Gg, Gs, Gs^Fp, Gs^Fms, Gs^Fms, Gs^Fp, Ss, Ss, Gs^Fp, Ss, Hh, Hhd, Gs^Fms, Hhd, Gs, Hh^Fp, Hhd^Fp, Gs^Efm, Gs^Fp, Gs^Fms, Gs^Fms, Hh^Fms
Ds, Gs^Ft, Gs^Ft, Ds, Ds, Ss, Ss, Sm, Ss, Ss, Ss, Ww, Wo, Wo, Ss, Ss, Gs^Ft, Gs^Ft, Gs^Fp, Gs^Fp, Gs^Fp, Gs^Fp, Ss, Ss, Ss, Ss, Gg, Ss, Hh, Md, Gs^Fp, Gs^Fp, Hh^Fp, Hh^Fp, Gs, Gg, Gs^Fp, Gs^Fms, Gs^Fp, Md
