Ww, Ww, Ww, Ww, Ww, Ww, Ww, Ww, Ds, Ds, Gs^Ft, Gg, Gg, Gg, Gs^Ft, Gs^Ft, Gs^Ft, Mm, Mm, Mm, Mm, Hhd, Hhd^Em, Hh, Hh, Mm, Mm, Hhd, Hhd, Ww, Ww, Gg, Gg^Efm, Gg, Gd, Gg, Gs, Gg, Gg^Efm, Gg
Ww, Ww, Ds, Ds, Ds, Ww, Ds, Ds, Gg, Gs^Ft, Gd, Gd, Gs^Ft, Gs, Gs, Gg, Gg, Gg, Gg, Mm, Hh, Mm, Hhd^Emf, Hhd^Em, Mm, Mm, Mm, Mm, Hhd, Ww, Ds, Gs, Gg, Gg, Gd, Gs, Chw, Gs^Ft, Gs^Ft, Gg
Ww, Ds, Chr, Chr, Chr, Ds, Gg, Gs, Ds, Wwf, Wwf, Wwf, Wwf, Gs^Ft, Gs, Gg^Efm, Gg, Mm, Mm, Mm, Hhd, Hhd^Em, Mm, Mm, Mm, Mm, Hhd, Hhd, Ww, Ww, Ww^Wkf, Ds, Ww^Wkf, Gg, Ww, Chw, 3 Khw, Chw, Ww, Gg
Ds, Ds, Chr, 1 Khr, Chr, Gd, Gs^Ft, Wwf, Ds, Wwf, Re, Re, Gs^Ft, Gs^Ft, Gg, Gg, Mm, Mm, Mm, Mm, Mm, Hhd, Hhd, Hh, Hh, Hh^Fms, Hhd^Em, Hhd, Ds, Ds, Re, Ww^Wkf, Gs^Fms, Gg, Ww, Chw, Chw, Chw, Ww, Ds
Gg, Gg, Gd, Chr, Gd, Gd, Gs^Vht, Wwf, Wwf, Ds, Re, Wwr, Ww^Wkf, Ww, Gg, Mm, Mm, Mm, Mm, Mm, Hh, Mm, Mm, Hhd, Hhd, Hhd^Em, Hhd^Emf, Hhd^Em, Ds, Ww, Re, Gs^Fms, Gg, Gg, Gg, Ww, Ww, Ww, Ds, Ds
Gs, Wwf, Wwf, Gs, Gs^Ft, Gg, Gg, Gs^Ft, Gg, Gs, Gs^Vht, Wwr, Wwr, Gg, Mm, Mm^Xm, Mm, Mm, Mm, Mm, Mm, Hh^Vhh, Hh^Fms, Hhd, Mm, Mm, Hhd^Em, Hhd^Em, Gs^Es, Re, Gs^Fms, Gs^Fms, Gg, Gs^Fms, Gg, Ds, Gs^Es, Ds, Gs, Gg
Re, Re, Ds, Wwf, Ds, Gs^Ft, Gg, Gg, Gg, Gg, Gs^Es, Ww, Ww, Gg, Hh, Mm, Hh^Fms, Mm, Mm, Mm, Mm, Mm, Mm, Mm, Gg, Hh, Re, Ww, Ww, Gs, Gg, Gg, Gg^Vh, Gg, Gg, Ds, Gg, Gs^Es, Gg, Gg
Re, Wwf, Ds, Wwf, Wwf, Wwf, Wwf, Gg, Gg^Efm, Gg, Gd, Gs^Es, Ds, Gg, Gg^Efm, Gg, Gg, Gs, Gd, Mm, Mm, Mm, Hh, Gs^Efm, Gg^Efm, Re, Wwr, Ds, Gs, Gg, Gg^Efm, Gg, Gg, Gg, Gs, Gs, Gd, Gg, Gg^Efm, Gg
Gs^Ft, Ds, Gg, Wwf, Gs^Ft, Gs^Ft, Gg, Gg, Gg, Gd, Gs, Ds, Ww, Ww, Ww, Ww, Gg, Gg, Hh^Vhh, Gd, Mm, Mm, Mm, Hh^Fms, Gg^Efm, Ds, Ww, Wwr, Gd, Gg, Gg, Gg, Gd, Gg, Chw, Gd, Gs^Ft, Wwf, Gs^Ft, Gg^Efm
Gs^Ft, Gg, Gg^Efm, Gg, Gg, Wwf, Gg, Gs^Ft, Gg, Gd, Gs, Ds, Ds, Ds, Re, Re, Gs, Hh, Mm, Mm, Mm, Mm, Hh^Fms, Hh^Fms, Gd, Ww, Wwr, Wwr, Gg, Gg, Gs, Gg^Vh, Gs, Wwf, Wwf, Wwf, Wwf, Gs^Ft, Gg, Gg^Efm
Gs^Ft, Gs^Ft, Gg, Gg, Gg, Gg, Gg, Gg, Gg, Gg^Efm, Gg, Gs, Gs, Re, Ds, Ww, Gs, Hh, Hh^Fms, Mm, Gs, Hh, Hh, Gs, Gg, Gs^Fms, Gs^Fms, Gs^Fms, Wwf, Ds, Wwf, Gs, Ds, Gs, Gg, Re, Re, Wwf, Gs, Gs
Gg, Gs, Gg, Gs^Ft, Gs^Es, Gs^Es, Ds, Gg, Gg^Efm, Gg, Gs^Ft, Gg, Wwf, Gs, Ds, Ww, Gg, Hh, Gg, Gs, Ww^Ewl, Gg, Gg, Gg, Gg^Vh, Gg, Gg, Gg^Efm, Ds, Ds, Wwf, Re, Ds, Ww, Ww, Ww, Re, Gg, Ds, Ds
Gg, Gs^Ft, Gg, Gd, Gs^Vht, Wwf, Ds, Gg, Gg^Efm, Gs^Ft, Wwf, Ds, Wwf, Gs, Ds, Ww^Wkf, Ww, Gg, Ww, Ww^Ewf, Wwr, Ww, Gs^Fms, Gg, Gg, Gg, Gd, Gg^Efm, Gg^Efm, Wwf, Wwf, Re, Re, Ds, Ww, Ds, Ds, Ds, Ww, Ww
Ds, Gg, Gd, Gd, Wwf, Ds, Wwf, Gg, Gg, Gs^Ft, Ds, Ds, Wwf, Gs^Vht, Gs, Ds, Ds, Ww, Gs, Wwr, Gs, Gs^Fms, Gg^Efm, Gg^Efm, Gs^Es, Gd, Chw, Gs, Gg, Wwf, Gd, Gs, Ds, Ds, Ww, Ww, Ww, Ww, Ww, Gg
Ww, Ds, Gs, Wwf, Re, Wwf, Wwf, Gs^Ft, Gg, Gs, Gs, Gs, Gd, Wwf, Gg, Gs^Ft, Gs^Ft, Gs^Ft, Gg, Gs, Gg, Gg, Ww, Gg, Gs^Es, Wwf, Wwf, Wwf, Gg, Gs^Fms, Gs, Ww, Ww, Ww, Ds, Ds, Ds, Re, Gs^Es, Gd
Ww, Ds, Ww, Re, Ww, Re, Gg, Gs^Ft, Gs^Ft, Gg, Gg, Gd, Gs^Es, Gg, Gs, Gg, Gs, Gs, Ds, Ds, Ww, Wwr, Wwr, Ds, Ds, Re, Re, Re, Gg, Gg, Gg, Ds, Ww^Ewl, Wwr, Ds, Ww, Re, Re, Gd^Es, Gg
Gg, Ww, Chw, Chw, Chw, Ds, Ds, Gg, Ww, Ww, Ds, Gs, Ww^Ewl, Re, Ww, Gg, Gs, Ds, Ww, Ww, Ds, Ww^Wkf, Ww, Ww, Ww, Ds, Ww, Ww, Ds, Ds, Ds, Ds, Ww^Ewf, Wwr, Ww^Wkf, Gs^Fms, Gg, Gd, Gg, Gg
Gg, Gs, Chw, 2 Khw, Chw, Ww, Ds, Wwr, Ww, Ds, Ww, Ds, Ww^Ewf, Re, Re, Gd, Gs, Ds, Ww, Ds, Ww, Ds, Ww^Wkf, Ds, Ds, Ww, Ds, Ww, Ww, Ww, Ww, Ww, Wwr, Wwr, Ww^Wkf, Gg, Gg^Ve, Gg, Gg^Efm, Gg
Gs^Ft, Gs, Gs, Chw, Ww, Ww, Ww, Ww, Ds, Ww^Wkf, Wwr, Wwr, Ww, Ww, Gg, Gs, Ds, Ds, Ww, Ds, Gg, Ww^Wkf, Gs^Fms, Ww^Wkf, Gg, Ds, Gg^Efm, Re, Re, Re, Gs^Es, Gs^Fms, Gs^Fms, Ww^Wkf, Gs^Fms, Gg, Gg, Gg, Gd, Gg
Gs^Ft, Gg, Gg, Re, Re, Re, Gg, Gg^Efm, Gg, Ww^Wkf, Ww^Wkf, Ww, Gg^Efm, Gg^Efm, Gg, Ds, Ww, Ww, Gg, Gg, Gg, Gs^Fms, Gd, Gd, Gg, Gg^Efm, Gg, Gs^Fms, Gg, Gs^Es, Gg, Gd, Gg, Gs^Fms, Gg, Gg^Efm, Gs, Gd, Gs, Gg
