Gs, Gg, Gg, Gs^Fp, Gg, Gs^Fp, Gs^Fp, Gg, Gs^Fp, Gs^Fp, Gs^Fp, Gs^Fp, Hh, Gs^Fp, Gs^Fp, Gs^Fp, Gs^Fp, Hh, Gg, Hh^Fp, Gg, Gg, Gg, Gg, Gg, Gg, Gg, Ww, Ww, Wo, Wo
Gs^Fp, Gs, Gs, Gs, Gs, Gg, Gg, Gs^Fp, Gs^Fp, Gs^Fp, Gs^Fp, Gs^Fp, Hh^Fp, Gs^Fp, Gs^Fp, Gs^Fp, Gs^Fp, Gs^Fp, Gs^Fp, Gs^Fp, Gg, Gg, Gs, Gs, Gs, Gg^Efm, Gg^Efm, Gg, Ww, Wo, Ww
Gs^Fp, Gs^Fp, Gs^Fp, Gs^Fp, Gs^Fp, Gs^Fp, Hh, Gs^Fp, Gs^Fp, Gs^Fp, Gs, Gs, Gs^Fp, Gs^Fp, Gg^Ve, Gg, Gg, Gg, Re, Re, Re, Gs^Fp, Gs^Fp, Gs^Fp, Gs^Fp, Gs, Gs, Gg, Gg, Ww, Ww
Gs^Fp, Gs^Fp, Gs^Fp, Gs^Fp, Gs^Fp, Hh^Fp, Gs^Fp, Gs, Gs, Gs, Hh, Gg, Gg, Gg, Hh, Gg, Re^Es, Re^Es, Gg, Gs^Fp, Gg, Re, Re, Gs^Fp, Gs^Fp, Gs^Fp, Gs, Gg, Gg, Gs^Fp, Gs^Fp
Gs^Fp, Gs^Fp, Gs^Fp, Gg^Ve, Hh, Gg, Gg, Gg, Gs^Fp, Gs^Fp, Gg, Gg, Gg, Gg, Mm, Re, Gg, Gg, Gg, Gs^Fp, Gs^Fp, Gg^Ve, Gg, Re, Re, Re, Gs, Gg, Gs^Fp, Gs^Fp, Gs^Fp
Gs^Fp, Gs^Fp, Gs^Fp, Hh^Fp, Gg, Gg, Gg, Gs^Fp, Gg, Gs^Fp, Gg, Gg^Efm, Gs, Hh, Chr, Re, Gg, Hh, Hh, Gg, Gg, Gg, Gs^Fp, Gs^Fp, Gg, Gs^Fp, Re, Gg, Gg, Gs^Fp, Gs^Fp
Gs^Fp, Gs^Fp, Gs^Fp, Gs^Fp, Gg, Gg^Efm, Gg, Gs^Fp, Gs^Fp, Gg, Gg, Gg^Ve, Chr^Edb, Chr, 1 Khr, Re, Gs^Edb, Gg, Gg, Gg, Gs^Fp, Gs^Fp, Gs^Fp, Gs^Fp, Gg, Gg, Re, Gg, Gg, Gs^Fp, Gg
Ww, Gs^Fp, Gs^Fp, Gs^Fp, Gs^Fp, Gs^Fp, Gg, Gg, Gg, Gg, Gg, Gs^Edb, Gs^Edb, Chr^Edb, Chr^Edb, Chr^Edb, Gs, Gg, Gs^Fp, Hh^Fp, Gs^Fp, Gs^Fp, Hh^Fp, Gs^Fp, Gs^Fp, Gg, Gg, Re, Gg, Gg, Gs^Fp
Ww, Wwr, Wwr, Wwr, Ww, Gs^Fp, Gg^Ve, Gs^Fp, Gs^Fp, Gs^Fp, Gs^Fp, Gg, Gg, Hh^Edb, Hh, Gs, Gs^Fp, Gs^Fp, Gs^Fp, Gs^Fp, Gs^Fp, Gg^Ve, Gs^Fp, Gs^Fp, Wwr, Ww^Ewl, Ww^Ewl, Re, Gg^Efm, Gg^Ve, Gs^Fp
Ww, Ww, Ww, Ww, Ww^Bw/r, Ww^Bw/r, Ww^Ewl, Gg, Gg, Gs^Fp, Gs^Fp, Gs^Fp, Gs^Fp, Gg, Gg^Efm, Gg^Efm, Hh, Gg, Gg, Gg, Gs, Gs^Fp, Ww, Ww, Ww, Ww, Ww, Re^Es, Re^Es, Gg, Gs^Fp
Wo, Wo, Wo, Wo, Wo, Ww, Ww, Gg, Ww, Gs^Fp, Gs^Fp, Gs^Fp, Gs, Gg, Gg, Gg, Gs^Fp, Hh, Gs^Fp, Gs, Ww, Ww, Ww, Wo, Wo, Wo, Wo, Ww, Re^Es, Gg, Gg
Wo, Wo, Wo, Wo, Wo, Ww, Ww, Ww^Bw\r, Gg^Ve, Gg, Gs^Fp, Gs^Fp, Gs^Fp, Gs, Gs, Gg, Gg, Gg, Gg, Ww, Ww, Wo, Wo, Wo, Gg^Ve, Wo, Wo, Ww, Ww, Re, Gg
Wo, Wo, Wo, Wo, Wo, Ww, Gg, Gg, Gg, Gs^Fp, Gs^Fp, Gs^Fp, Gs^Fp, Gs^Fp, Gs^Fp, Gs, Gs, Gg^Es, Gg, Gg, Ww, Wo, Wo, Wo, Gg, Wo, Wo, Ww, Ww, Re, Gg
Ww, Wo, Wo, Wo, Wo, Ww, Hh, Gg, Gs, Gg, Gs^Fp, Gs^Fp, Hh, Hh, Mm, Gs^Fp, Gs^Fp, Gs^Es, Gs^Es, Ww, Ww, Wo, Wo, Wo, Hh, Wo, Wo, Wo, Ww, Re, Gg
Ww, Ww, Ww, Ww, Ww, Ww, Ww, Hh^Em, Hh^Emf, Hh^Em, Hh^Vhh, Gs^Fp, Mm, Gs^Fp, Hh, Hh, Hh, Gs^Fp, Gs, Ww^Ewl, Ww, Ww, Wo, Wo, Hh^Vhh, Wo, Wo, Wo, Ww, Re, Gg
Ww, Ww, Ww^Bw/r, Gg, Ww, Gg, Gg^Ve, Hh^Em, Mm, Mm^Xm, Mm, Hh, Hh, Hh, Mm, Mm, Gs^Fp, Gs^Fp, Gs^Fp, Ww, Ww, Wo, Wo, Wo, Wo, Wo, Wo, Ww, Ww, Re, Gg
Ww, Gg^Ve, Ww, Gg, Gs, Gs, Gg, Gg, Hh, Mm, Mm, Mm, Hh^Vhh, Mm, Mm, Mm, Hh, Hh, Gs, Gg, Ww, Ww, Ww, Ww, Ww, Wo, Wo, Ww, Ww^Bw\r, Gg, Hh
Ww, Ww, Wwr, Wwr, Gg, Gg^Efm, Gg, Gs, Gs^Fp, Gs^Fp, Gs^Fp, Hh^Emf, Hh^Em, Hh^Em, Mm, Mm^Xm, Mm, Hh^Vhh, Hh, Gg, Gg, Gg, Ww, Wwr, Ww, Wo, Ww, Ww, Re, Gg^Ve, Hh^Fp
Ww, Gs, Gg, Gg, Gg^Ve, Gg, Gs, Gs, Gs^Fp, Gs^Fp, Hh, Hh^Em, Mm, Mm, Mm, Mm, Hh, Hh, Gs^Fp, Gs^Fp, Gs^Fp, Gg, Gg, Ww, Ww, Ww, Ww, Re^Es, Hh, Hh, Hh^Fp
Ww, Gs, Gs, Gg, Gg, Gg, Gs^Fp, Gs^Fp, Gs^Fp, Hh, Mm, Mm, Mm, Hh^Em, Mm, Mm, Mm, Mm, Mm, Gs^Fp, Gs^Fp, Gs^Fp, Gg, Gg^Ve, Wwr, Wwr, Ww^Bw/r, Ww^Bw/r, Gg, Gs^Fp, Gs^Fp
Wo, Ww, Hh, Hh, Gg, Gg^Es, Gs^Es, Gs^Fp, Gs^Fp, Gs^Fp, Mm, Hh, Hh^Em, Hh^Emf, Hh^Em, Mm, Mm, Hh, Gs^Fp, Gs^Fp, Gs^Fp, Gs^Fp, Re, Ww, Ww^Bw/r, Ww^Bw/r, Ww^Ewl, Gg, Gg^Ve, Gs^Fp, Gs^Fp
Wo, Ww, Ww, Ww, Gs^Fp, Gs^Es, Gs^Fp, Gs^Fp, Gs^Fp, Hh, Hh, Hh, Mm, Mm, Mm, Hh, Hh, Hh, Hh, Gs^Fp, Gs^Fp, Gg, Re, Ww^Bw/r, Ww, Ww, Ww^Ewf, Gg, Gs^Fp, Gs^Fp, Gs^Fp
Ww, Ww^Ewl, Ww^Ewl, Gg, Gg, Gs, Gs, Gs, Gs^Fp, Gs^Fp, Gg, Gg, Gs^Fp, Hh, Hh, Gs^Fp, Gs^Fp, Gs^Fp, Gs^Fp, Gs^Fp, Re, Re, Gg, Gs, Ww, Ww^Ewl, Gg, Gg, Gg^Efm, Gs^Fp, Hh^Fp
Gg, Gg, Gg, Gg, Gg, Gg, Gs^Fp, Gs^Fp, Gs^Fp, Gg, Chr^Edb, Gs^Edb, Gs^Fp, Gg, Hh, Gg, Re, Chr, Re, Re, Gg^Efm, Gg, Gs, Gs, Ww, Gs, Gg, Gs^Fp, Gs^Fp, Gs^Fp, Hh
Gg, Gg, Gg, Gg, Gs^Fp, Gs^Fp, Hh, Hh, Gs^Fp, Chr^Edb, Chr^Edb, 2 Khr, Re^Edb, Hh, Hh, Re, Gs^Fp, Re, Gg, Gg, Gg, Gg, Gs, Wwr, Ww, Gs, Gs, Gg, Gs^Fp, Hh, Mm
Gg, Gg^Efm, Gg, Gg^Ve, Gs, Gs, Gs^Fp, Gs^Fp, Gs^Fp, Hh, Gg^Edb, Chr^Edb, Chr^Edb, Re, Re, Re^Es, Hh, Hh, Gs^Fp, Gs^Fp, Ww^Ewl, Ww^Ewl, Ww, Ww, Wo, Ww, Ww, Gs, Hh, Mm, Mm
Gg, Gg^Efm, Gg^Efm, Gg, Gs, Gs^Fp, Gs^Fp, Hh, Hh, Gg, Gg, Gg^Edb, Gg^Edb, Gs, Gs, Gs, Gs, Mm, Mm, Ww, Ww, Ww, Wo, Wo, Wo, Wo, Ww, Ww, Hh, Mm, Mm
Gg, Gg, Gg, Gg, Gs, Gs^Fp, Hh^Fp, Hh^Fp, Gs^Fp, Hh^Fp, Hh^Fp, Hh^Fp, Gg, Gg, Hh^Fp, Gg, Hh, Hh, Hh, Ww, Wo, Wo, Wo, Wo, Wo, Wo, Wo, Ww, Hh, Mm, Mm
