border_size=1
usage=map

Gg          , Gg          , Gg          , Gs^Fp       , Gg          , Gs^Fp       , Gs^Fp       , Gg          , Gs^Fp       , Gs^Fp       , Gs^Fp       , Gs^Fp       , Hh          , Gs^Fp       , Gs^Fp       , Gs^Fp       , Gs^Fp       , Hh          , Gg          , Hh^Fp       , Gg          , Gg          , Gg          , Gg          , Gg          , Gg          , Gg          , Ww          , Ww          , Wo          , Wo          
Gs^Fp       , Gg          , Gg          , Gg          , Gg          , Gg          , Gg          , Gs^Fp       , Gs^Fp       , Gs^Fp       , Gs^Fp       , Gs^Fp       , Hh^Fp       , Gs^Fp       , Gs^Fp       , Gs^Fp       , Gs^Fp       , Gs^Fp       , Gs^Fp       , Gs^Fp       , Gg          , Gg          , Gg          , Gg          , Gg          , Gg          , Gg          , Gg          , Ww          , Wo          , Ww          
Gs^Fp       , Gs^Fp       , Gs^Fp       , Gs^Fp       , Gs^Fp       , Gs^Fp       , Hh          , Gs^Fp       , Gs^Fp       , Gs^Fp       , Gg          , Gg          , Gs^Fp       , Gs^Fp       , Gg^Ve       , Gg          , Gg          , Gg          , Re          , Re          , Re          , Gs^Fp       , Gs^Fp       , Gs^Fp       , Gs^Fp       , Gg          , Gg          , Gg          , Gg          , Ww          , Ww          
Gs^Fp       , Gs^Fp       , Gs^Fp       , Gs^Fp       , Gs^Fp       , Hh^Fp       , Gs^Fp       , Gg          , Gg          , Gg          , Hh          , Gg          , Gg          , Gg          , Hh          , Gg          , Re          , Re          , Gg          , Gs^Fp       , Gg          , Re          , Re          , Gs^Fp       , Gs^Fp       , Gs^Fp       , Gg          , Gg          , Gg          , Gs^Fp       , Gs^Fp       
Gs^Fp       , Gs^Fp       , Gs^Fp       , Gg^Ve       , Hh          , Gg          , Gg          , Gg          , Gs^Fp       , Gs^Fp       , Gg          , Gg          , Gg          , Gg          , Mm          , Re          , Gg          , Gg          , Gg          , Gs^Fp       , Gs^Fp       , Gg^Ve       , Gg          , Re          , Re          , Re          , Gg          , Gg          , Gs^Fp       , Gs^Fp       , Gs^Fp       
Gs^Fp       , Gs^Fp       , Gs^Fp       , Hh^Fp       , Gg          , Gg          , Gg          , Gs^Fp       , Gg          , Gs^Fp       , Gg          , Gg          , Gg          , Hh          , Chr         , Re          , Gg          , Hh          , Hh          , Gg          , Gg          , Gg          , Gs^Fp       , Gs^Fp       , Gg          , Gs^Fp       , Re          , Gg          , Gg          , Gs^Fp       , Gs^Fp       
Gs^Fp       , Gs^Fp       , Gs^Fp       , Gs^Fp       , Gg          , Gg          , Gg          , Gs^Fp       , Gs^Fp       , Gg          , Gg          , Gg^Ve       , Chr         , Chr         , 1 Khr       , Re          , Gg          , Gg          , Gg          , Gg          , Gs^Fp       , Gs^Fp       , Gs^Fp       , Gs^Fp       , Gg          , Gg          , Re          , Gg          , Gg          , Gs^Fp       , Gg          
Ww          , Gs^Fp       , Gs^Fp       , Gs^Fp       , Gs^Fp       , Gs^Fp       , Gg          , Gg          , Gg          , Gg          , Gg          , Gg          , Gg          , Chr         , Chr         , Chr         , Gg          , Gg          , Gs^Fp       , Hh^Fp       , Gs^Fp       , Gs^Fp       , Hh^Fp       , Gs^Fp       , Gs^Fp       , Gg          , Gg          , Re          , Gg          , Gg          , Gs^Fp       
Ww          , Ww          , Ww          , Ww          , Ww          , Gs^Fp       , Gg^Ve       , Gs^Fp       , Gs^Fp       , Gs^Fp       , Gs^Fp       , Gg          , Gg          , Hh          , Hh          , Gg          , Gs^Fp       , Gs^Fp       , Gs^Fp       , Gs^Fp       , Gs^Fp       , Gg^Ve       , Gs^Fp       , Gs^Fp       , Ww          , Ww          , Ww          , Re          , Gg          , Gg^Ve       , Gs^Fp       
Ww          , Ww          , Ww          , Ww          , Ww^Bw/      , Ww^Bw/      , Ww          , Gg          , Gg          , Gs^Fp       , Gs^Fp       , Gs^Fp       , Gs^Fp       , Gg          , Gg          , Gg          , Hh          , Gg          , Gg          , Gg          , Gg          , Gs^Fp       , Ww          , Ww          , Ww          , Ww          , Ww          , Re          , Re          , Gg          , Gs^Fp       
Wo          , Ww          , Wo          , Wo          , Wo          , Ww          , Ww          , Gg          , Ww          , Gs^Fp       , Gs^Fp       , Gs^Fp       , Gg          , Gg          , Gg          , Gg          , Gs^Fp       , Hh          , Gs^Fp       , Gg          , Ww          , Ww          , Ww          , Wo          , Wo          , Wo          , Wo          , Ww          , Re          , Gg          , Gg          
Wo          , Wo          , Wo          , Wo          , Wo          , Ww          , Ww          , Ww^Bw\      , Gg^Ve       , Gg          , Gs^Fp       , Gs^Fp       , Gs^Fp       , Gg          , Gg          , Gg          , Gg          , Gg          , Gg          , Ww          , Ww          , Wo          , Wo          , Gg          , Gg^Ve       , Wo          , Wo          , Ww          , Ww          , Re          , Gg          
Wo          , Wo          , Wo          , Wo          , Ww          , Ww          , Gg          , Gg          , Gg          , Gs^Fp       , Gs^Fp       , Gs^Fp       , Gs^Fp       , Gs^Fp       , Gs^Fp       , Gg          , Gg          , Gg          , Gg          , Gg          , Ww          , Wo          , Wo          , Wo          , Gg          , Wo          , Wo          , Ww          , Ww          , Re          , Gg          
Ww          , Wo          , Wo          , Wo          , Wo          , Ww          , Hh          , Gg          , Gg          , Gg          , Gs^Fp       , Gs^Fp       , Hh          , Hh          , Mm          , Gs^Fp       , Gs^Fp       , Gg          , Gg          , Ww          , Ww          , Wo          , Wo          , Wo          , Hh          , Wo          , Wo          , Wo          , Ww          , Re          , Gg          
Ww          , Ww          , Ww          , Ww          , Ww          , Ww          , Ww          , Hh          , Hh          , Hh          , Hh^Vhh      , Gs^Fp       , Mm          , Gs^Fp       , Hh          , Hh          , Hh          , Gs^Fp       , Gg          , Ww          , Ww          , Ww          , Wo          , Wo          , Hh^Vhh      , Wo          , Wo          , Wo          , Ww          , Re          , Gg          
Ww          , Ww          , Ww^Bw/      , Gg          , Ww          , Gg          , Gg^Ve       , Hh          , Mm          , Mm          , Mm          , Hh          , Hh          , Hh          , Mm          , Mm          , Gs^Fp       , Gs^Fp       , Gs^Fp       , Ww          , Ww          , Wo          , Wo          , Wo          , Wo          , Wo          , Wo          , Ww          , Ww          , Re          , Gg          
Ww          , Gg^Ve       , Ww          , Gg          , Gg          , Gg          , Gg          , Gg          , Hh          , Mm          , Mm          , Mm          , Hh^Vhh      , Mm          , Mm          , Mm          , Hh          , Hh          , Gg          , Gg          , Ww          , Ww          , Ww          , Ww          , Ww          , Wo          , Wo          , Ww          , Ww^Bw\      , Gg          , Hh          
Ww          , Ww          , Ww          , Wo          , Gg          , Gg          , Gg          , Gg          , Gs^Fp       , Gs^Fp       , Gs^Fp       , Hh          , Hh          , Hh          , Mm          , Mm          , Mm          , Hh^Vhh      , Hh          , Gg          , Gg          , Gg          , Ww          , Gg          , Ww          , Wo          , Ww          , Ww          , Re          , Gg^Ve       , Hh^Fp       
Ww          , Gg          , Gg          , Gg          , Gg^Ve       , Gg          , Gg          , Gs^Fp       , Gs^Fp       , Gs^Fp       , Hh          , Hh          , Mm          , Mm          , Mm          , Mm          , Hh          , Hh          , Gs^Fp       , Gs^Fp       , Gs^Fp       , Gg          , Gg          , Ww          , Ww          , Ww          , Ww          , Re          , Hh          , Hh          , Hh^Fp       
Ww          , Gg          , Gg          , Gg          , Gg          , Gg          , Gs^Fp       , Gs^Fp       , Gs^Fp       , Hh          , Mm          , Mm          , Mm          , Hh          , Mm          , Mm          , Mm          , Mm          , Mm          , Gs^Fp       , Gs^Fp       , Gs^Fp       , Gg          , Gg^Ve       , Ww          , Ww          , Ww^Bw/      , Ww^Bw/      , Gg          , Gs^Fp       , Gs^Fp       
Wo          , Ww          , Hh          , Hh          , Gg          , Gg          , Gg          , Gs^Fp       , Gs^Fp       , Gs^Fp       , Mm          , Hh          , Hh          , Hh          , Hh          , Mm          , Mm          , Hh          , Gs^Fp       , Gs^Fp       , Gs^Fp       , Gs^Fp       , Re          , Ww          , Ww^Bw/      , Ww^Bw/      , Ww          , Gg          , Gg^Ve       , Gs^Fp       , Gs^Fp       
Wo          , Wo          , Ww          , Ww          , Gs^Fp       , Gg          , Gs^Fp       , Gs^Fp       , Gs^Fp       , Hh          , Hh          , Hh          , Mm          , Mm          , Mm          , Hh          , Hh          , Hh          , Hh          , Gs^Fp       , Gs^Fp       , Gg          , Re          , Ww^Bw/      , Ww          , Ww          , Ww          , Gg          , Gs^Fp       , Gs^Fp       , Gs^Fp       
Ww          , Ww          , Ww          , Gg          , Gg          , Gg          , Gg          , Gg          , Gs^Fp       , Gs^Fp       , Gg          , Gg          , Gs^Fp       , Hh          , Hh          , Gs^Fp       , Gs^Fp       , Gs^Fp       , Gs^Fp       , Gs^Fp       , Re          , Re          , Gg          , Gg          , Ww          , Ww          , Gg          , Gg          , Gg          , Gs^Fp       , Hh^Fp       
Gg          , Gg          , Gg          , Gg          , Gg          , Gg          , Gs^Fp       , Gs^Fp       , Gs^Fp       , Gg          , Chr         , Gg          , Gs^Fp       , Gg          , Hh          , Gg          , Re          , Chr         , Re          , Re          , Gg          , Gg          , Gg          , Gg          , Ww          , Gg          , Gg          , Gs^Fp       , Gs^Fp       , Gs^Fp       , Hh          
Gg          , Gg          , Gg          , Gg          , Gs^Fp       , Gs^Fp       , Hh          , Hh          , Gs^Fp       , Chr         , Chr         , 2 Khr       , Re          , Hh          , Hh          , Re          , Gs^Fp       , Re          , Gg          , Gg          , Gg          , Gg          , Gg          , Ww          , Ww          , Gg          , Gg          , Gg          , Gs^Fp       , Hh          , Mm          
Gg          , Gg          , Gg          , Gg^Ve       , Gg          , Gg          , Gs^Fp       , Gs^Fp       , Gs^Fp       , Hh          , Gg          , Chr         , Chr         , Re          , Re          , Re          , Hh          , Hh          , Gs^Fp       , Gs^Fp       , Ww          , Ww          , Ww          , Ww          , Wo          , Wo          , Ww          , Gg          , Hh          , Mm          , Mm          
Gg          , Gg          , Gg          , Gg          , Gg          , Gs^Fp       , Gs^Fp       , Hh          , Hh          , Gg          , Gg          , Gg          , Gg          , Gg          , Gg          , Gg          , Gg          , Mm          , Mm          , Ww          , Ww          , Ww          , Wo          , Wo          , Wo          , Wo          , Wo          , Ww          , Hh          , Mm          , Mm          
Gg          , Gg          , Gg          , Gg          , Gg          , Gs^Fp       , Hh^Fp       , Hh^Fp       , Gs^Fp       , Hh^Fp       , Hh^Fp       , Hh^Fp       , Gg          , Gg          , Hh^Fp       , Gg          , Hh          , Hh          , Hh          , Ww          , Wo          , Wo          , Wo          , Wo          , Wo          , Wo          , Wo          , Wo          , Hh          , Mm          , Mm          
