Gs, Gg, Gg, Gs^Fp, Gg, Gs^Fp, Gs^Fp, Gg, Gs^Fp, Gs^Fp, Gs^Fp, Gs^Fp, Hh, Gs^Fp, Gs^Fp, Gs^Fp, Gs^Fp, Hh, Gg, Hh^Fp, Gs, Gs, Gs, Gs, Gs, Gs, Gs, Gd^Em, Ss^Em, Sm, Sm
Gs^Fmw, Gs, Gs, Gs, Gs, Gg, Gs, Gs^Fms, Gs^Fp, Gs^Fp, Gs^Fms, Gs^Fp, Hh^Fp, Gg^Fet, Gs^Fp, Gs^Fp, Gs^Fp, Gs^Fp, Gs^Fp, Gs^Fp, Gs, Gs, Gs, Gs, Gg^Efm, Gs, Gs, Gd^Em, Ww, Sm, Ss
Gs^Fp, Gs^Fmw, Gs^Fmw, Gs^Fmw, Gs^Fp, Gs^Fp, Hh, Gs^Fms, Gs^Fms, Gs^Fms, Gs, Gs, Gs^Fp, Gs^Fp, Gg^Ve, Gs, Gg, Gg, Re, Re^Es, Re^Efm, Gs^Fp, Gs^Fp, Gs^Fp, Gs^Fp, Gs, Gs, Gg, Gs^Efm, Ss, Ss
Gs^Fp, Gs^Fp, Gs^Fds, Gs^Fp, Gs^Fp, Hh^Fp, Gs^Fmw, Gg, Gs, Gs, Hh, Gs, Gg, Gs, Hh, Gs, Re, Re, Gd, Gs^Fmw, Gs, Re, Re, Gs^Fmw, Gs^Fp, Gs^Fp, Gg, Gg^Efm, Gs^Fmw, Gs^Fp, Gs^Fp
Gs^Fp, Gs^Fp, Gs^Fds, Hh, Hh, Gs, Gs, Gs, Gg^Fet, Gs^Fmw, Gs^Edt, Gd, Gs, Gs, Mm, Re, Gg, Gs, Gs, Gs^Fmw, Gs^Fmw, Gs^Vl, Gg, Re, Re, Re, Gg, Gs, Gs^Fmw, Gs^Fp, Gs^Fp
Gs^Fp, Gs^Fp, Gs^Fds, Hh^Fms, Gd^Es, Gg, Gg, Gs^Fds, Gg, Gs^Fms, Gs, Gs^Edt, Gs, Hh, Cvr, Re, Gg^Ecf, Hh, Hh, Gs, Gs, Gs, Gs^Fmw, Gs^Fmw, Gs, Gg^Fet, Re, Gs, Gg^Efm, Gs^Fp, Gs^Fp
Gs^Fp, Gs^Fds, Gs^Fp, Gs^Fms, Gs, Gg, Gg, Gs^Fp, Gs^Fp, Gg, Gg, Gs^Vl, Cvr, Cvr^Edt, 1 Kvr, Re^Edt, Gg, Gg, Gs^Edt, Gs, Gs^Fmw, Gs^Fmw, Gs^Fp, Gs^Fmw, Gs, Gs, Re, Gs, Gg, Gs^Fp, Gg
Ww, Gs^Fp, Gs^Fp, Gs^Fp, Gs^Fmw, Gs^Fp, Gg, Gs, Gs, Gs, Gs^Edt, Gs, Gg, Cvr^Edt, Cvr, Cvr^Edt, Gs^Edt, Gs^Edt, Gs^Fms, Hh^Fp, Gs^Fp, Gs^Fp, Hh^Fp, Gs^Fp, Gs^Fp, Gd^Em, Gd^Em, Re, Gg, Gg, Gs^Fp
Ss, Ww, Ww, Wo, Ww, Gs^Fp, Gd^Ve, Gs^Fp, Gs^Fds, Gs^Fp, Gs^Fds, Gs, Gs, Hh, Hh, Gs, Gs^Fmw, Gs^Fms, Gs^Fmw, Gs^Fms, Gs^Fp, Ss^Vhs, Gs^Fp, Gs^Fp, Ww^Ewl, Wo, Wo, Re, Gd, Hh, Gs^Fp
Ss, Ss, Ss^Em, Ss, Ss^Bw/, Ss^Bw/, Ss, Gg, Gg, Gs^Fp, Gs^Fp, Gs^Fds, Gs^Fds, Gs^Edt, Gd^Edt, Gd, Hh, Gg, Gg, Gg, Gd^Em, Gs^Fp, Ss, Ww, Ss, Ss, Ss, Re, Re, Gg, Gs^Fp
Ww, Sm, Sm, Ww, Wo, Ss, Ss, Gg, Ss, Gs^Fmw, Gs^Fmw, Gs^Fds, Gs, Gs^Edt, Gd, Gg, Gs^Fp, Hh, Gs^Fp, Gd, Ww, Ss, Ss, Sm, Sm, Sm, Sm, Ss, Re^Es, Gd, Gg
Wo, Ww, Ww, Ww, Ww, Sm, Ss, Ss^Bw\, Ss^Vhs, Gd, Gs^Fp, Gs^Fds, Gs^Fds, Gs, Gs, Gg, Gg, Gg^Efm, Gg^Efm, Ss, Ss, Sm, Sm, Sm, Ss^Vhs, Sm, Sm, Ss, Ss, Re, Gg
Ww, Wo, Sm, Sm, Ss, Ss, Gg, Gg, Gg, Gs^Fp, Gs^Fmw, Gs^Fds, Gs^Fp, Gs^Fds, Gs^Fp, Gs, Gs, Gg^Efm, Gs, Gs, Ss, Ww, Ww^Ewl, Ss, Wo, Sm, Sm, Ss, Ss, Re, Gg
Ss, Ww, Ww, Ww, Ww, Ss, Hhd^Em, Gd, Gs, Gs, Gs^Fp, Gs^Fp, Hh, Hh, Mm, Gs^Fp, Gs^Fms, Gg^Efm, Gs, Ss, Ss^Em, Ww, Ww, Ww, Ww, Ww, Ww, Sm, Ss, Re, Gg
Ss, Ss, Ss, Ss, Ss, Ss, Ss, Hhd, Hh, Hh, Hh^Vhh, Gs^Fp, Md, Gs^Fp, Hhd, Hhd^Em, Hhd^Em, Gs^Fms, Gg, Ss, Ss, Ss, Sm, Ss, Ss^Vhs, Sm, Sm, Sm, Ss, Re, Gs
Ss, Ss, Ss^Bw/, Gs^Em, Ss, Gs, Gg^Ve, Hh, Mm, Mm, Mm, Hh, Hhd, Hhd, Mm, Md, Gs^Fms, Gg^Fet, Gs^Fp, Ss, Wo, Ww, Sm, Sm, Sm, Sm, Sm, Ss, Ss, Re, Gs
Ss, Ss^Vhs, Ss, Gs, Gs, Gg, Gg, Gs, Hh, Md, Md, Mm, Hhd^Vhhr, Mm, Mm, Mm, Hh, Hh, Gg, Gs, Ss, Ww, Ww, Ww, Ss, Sm, Sm, Ss, Ss^Bw\, Gs, Hh
Ss, Ss, Ss, Sm, Gd^Es, Gs, Gs, Gs, Gs^Fp, Gs^Fp, Gs^Fms, Hhd^Em, Hhd, Hhd, Mm^Xm, Mm, Mm, Hh^Vhh, Hh, Gg, Gg, Gd, Ss, Gs, Ss, Sm, Ss, Ss, Re, Gg^Efm, Hh^Fp
Ss, Gs, Gs, Gs, Gs^Vh, Gg, Gs, Gs^Fp, Gs^Fms, Gs^Fms, Hhd^Em, Hhd^Em, Mm, Mm, Mm, Mm, Hh, Hh, Gs^Fp, Gs^Fp, Gs^Fp, Gg, Gg, Ss, Ss, Ss, Ss, Re^Es, Hh^Fmw, Hh^Fmw, Hh^Fp
Ss, Gg^Efm, Gg^Fmw, Gg, Gg, Gg, Gs^Fmw, Gs^Fp, Gs^Fds, Hhd^Em, Md, Mm, Mm, Hh^Fmw, Mm, Mm, Md, Md, Md, Gs^Fp, Gs^Fms, Gs^Fms, Gg, Gg^Ve, Ss, Ss^Em, Ss^Bw/, Ss^Bw/, Gs, Gs^Fmw, Gs^Fp
Sm, Ss, Hh, Hh^Fmw, Gg, Gs, Gs, Gs^Fp, Gs^Fms, Gs^Fms, Md, Hhd^Em, Hh, Hh^Fmw, Hh, Mm, Mm, Hhd, Gs^Fp, Gs^Fp, Gs^Fmw, Gs^Fp, Re, Ss, Ss^Bw/, Ss^Bw/, Ss, Gs, Gd^Ve, Gs^Fp, Gs^Fp
Sm, Sm, Ss, Ss, Gs^Fms, Gs, Gs^Fms, Gs^Fms, Gg^Fet, Hh, Hh, Hh, Mm, Mm, Mm, Hh, Hhd, Hhd^Em, Hhd^Em, Gs^Fds, Gs^Fp, Gg, Re, Ss^Bw/, Ww, Ww, Ww, Gs, Gs^Fp, Gs^Fp, Gs^Fp
Ss, Ss, Ss, Gs, Gg, Gg, Gg^Edt, Gg^Edt, Gs^Fp, Gs^Fp, Gg^Edt, Gs^Edt, Gs^Fp, Hhd, Hhd^Fmw, Gs^Fms, Gs^Fms, Gs^Fms, Gs^Fms, Gs^Fds, Re^Efm, Re, Gg^Efm, Gg, Ss, Ss, Gg^Efm, Gg^Efm, Gg, Gs^Fds, Hh^Fp
Gg, Hh, Gg, Gg^Efm, Gg, Gs, Gs^Fmw, Gs^Fmw, Gs^Fp, Gg, Cvr^Edt, Gg, Gs^Fp, Gg^Efm, Hhd, Gs, Re^Edt, Cvr, Re, Re^Es, Gg, Gg^Efm, Gg, Gg^Efm, Ss, Gg, Gg, Gs^Fds, Gs^Fmw, Gs^Fds, Hh
Gg, Gg, Gd^Em, Gd^Em, Gs^Fp, Gs^Fmw, Hh, Hh, Gs^Fms, Cvr, Cvr^Edt, 2 Kvr, Re, Hhd, Hhd, Re^Edt, Gs^Fds, Re, Gs, Gs, Gs^Em, Gd^Em, Gs^Em, Ss, Ss, Gs^Vh, Gg, Gd, Gs^Fms, Hh, Mm
Gs, Gs, Gd^Em, Gg^Ve, Gs, Gs, Gs^Fmw, Gs^Fms, Gs^Fms, Hh, Gg^Ecf, Cvr^Edt, Cvr, Re^Edt, Re^Edt, Re^Edt, Hh^Fmw, Hh, Gs^Fp, Gs^Fp, Ss, Wo, Ww, Ss, Sm^Em, Ss, Ss, Gg, Hh, Mm, Mm
Gs, Gs^Em, Gs, Gs, Gg^Efm, Gs^Fp, Gs^Fp, Hh, Hh, Gs, Gs^Em, Gs, Gg^Efm, Gg^Efm, Gg^Efm, Gs, Gs^Edt, Mm, Mm, Ss, Ss, Ww, Sm, Sm, Sm, Ss, Sm, Ss, Hh, Mm, Mm
Gs, Gs, Gs, Gs, Gs, Gs^Fp, Hh^Fp, Hh^Fp, Gs^Fp, Hh^Fp, Hh^Fp, Hh^Fp, Gg, Gg, Hh^Fp, Gg, Hh, Hh, Hh, Ss, Sm, Sm, Sm, Ss, Sm, Sm, Sm, Sm, Hh, Mm, Mm
