Gs^Es, Gs, Gg, Gs^Fp, Gd, Gs^Fp, Gd^Fp, Gg, Gs^Fp, Gs^Fp, Gs^Fp, Gs^Fp, Hh, Gs^Fp, Gs^Fp, Gs^Fp, Gs^Fp, Hh, Gs, Hh^Fp, Gs, Gs, Gg, Gg, Gs, Gg, Gg, Ds, Ww, Wo, Wo
Gs^Fp, Gd^Es, Gs, Gs, Gll, Gg, Gg, Gs^Fp, Gs^Fp, Gs^Fp, Gs^Fp, Gs^Fp, Hh^Fp, Gs^Fp, Gs^Fp, Gs^Fp, Gs^Fp, Gs^Fp, Gs^Fp, Gs^Fp, Gd^Edb, Gd^Edb, Gll^Edb, Gd^Edb, Gs^Fp, Gs, Gg, Ds, Ww^Wkf, Wo, Wwr
Gs^Fp, Gs^Fp, Gs^Fp, Gs^Fp, Gs^Fp, Hhd^Fp, Hh, Gs^Fp, Gs^Fp, Gs^Fp, Gs, Gs, Gs^Fp, Gs^Fp, Gg^Ve, Gg, Gg, Gs, Rb, Rb, Re, Gs^Fp, Gs^Fp, Gs^Fp, Gs^Fetd, Gs, Gg, Gg^Efm, Ds, Ww^Wkf, Ww^Wkf
Gs^Fp, Gs^Fp, Gs^Fp, Gs^Fp, Gs^Fp, Hhd^Fp, Gs^Fp, Gg, Gg, Gg, Hhd, Gs, Gg, Gg, Hh, Gll, Rb, Re^Es, Gg, Gs^Fp, Gg, Re, Rb, Gs^Fp, Gs^Fp, Gs^Fp, Rr, Gg, Gs, Gs^Fp, Gs^Fp
Gs^Fp, Gs^Fp, Gs^Fp, Hh^Fp, Hhd, Gd, Gs, Gs^Edb, Gs^Fp, Gs^Fp, Gg, Gs, Gll, Gd, Mm, Rb, Gd, Gll, Gd, Gs^Fp, Gs^Fp, Gs^Vh, Gg, Rb, Re, Re, Gd^Es, Rr, Gs^Fp, Gs^Fp, Gs^Fp
Gs^Fp, Gs^Fp, Gs^Fp, Hh^Fp, Gd, Gd^Edb, Gs^Edb, Gs^Fp, Gg, Gs^Fp, Gg, Gs, Gd^Em, Hhd^Dr, Chr, Rb^Edb, Gs^Edb, Hh, Hhd^Dr, Gs, Gg, Gg, Gs^Fp, Gs^Fp, Gs, Gs^Fp, Re, Gd^Es, Gs^Edb, Gs^Fp, Gs^Fp
Gll^Fp, Gs^Fetd, Gs^Fp, Gs^Fp, Gg, Gg, Gd, Gs^Fp, Gs^Fp, Gg^Efm, Gg, Gg^Ve, Chr, Chr, 1 Khr, Rr^Edb, Gs^Edb, Gs, Gg, Gs, Hh^Fp, Gs^Fp, Gs^Fp, Gs^Fp, Gs^Edb, Gd, Re^Es, Gd, Gs^Edb, Gs^Fp, Gd
Ww, Gll^Fp, Gll^Fp, Gs^Fp, Gll^Fp, Gs^Fp, Gg, Gs, Gg, Gg, Gd, Gs^Edb, Gd^Edb, Chr^Edb, Chr, Chr, Gg, Gg, Gs^Fp, Hhd^Fp, Gs^Fp, Gs^Fp, Hh^Fp, Gs^Fp, Gs^Fp, Gg, Ds^Ewsh, Re, Gg, Gd^Edb, Gs^Fp
Ww, Ww, Ww, Ww^Ewl, Ww, Gll^Fp, Gs^Ve, Gs^Fp, Gs^Fp, Gs^Fp, Gs^Fp, Gd, Gs, Hhd^Edb, Hh^Em, Gs, Gs^Fp, Gs^Fp, Hh^Fp, Gs^Fp, Gs^Fp, Gg^Ve, Gs^Fp, Gs^Fp, Ww, Wwr, Ww, Re, Gll, Gs^Fp, Gs^Fp
Wwr, Wo, Wwr, Ww, Ww^Bw/r, Ww^Bw/r, Wwr, Gg, Gg, Gs^Fet, Gs^Fp, Gs^Fp, Gs^Fp, Gs^Edb, Gs, Gs, Hh, Rr, Rr, Ds, Ds, Gs^Fp, Ww, Ww, Ww^Ewl, Ww, Ww^Wkf, Re, Gll, Gg, Gs^Fp
Wo, Wwr, Wo, Wo, Wo, Ww, Ww, Gll, Ww, Gs^Fp, Gs^Fp, Gs^Fp, Gd^Edb, Gg, Gg^Efm, Gg, Gs^Fp, Hhd^Em, Gs^Fp, Gs^Fp, Ww, Ww, Ww, Wo, Wo, Wo, Wo, Ww^Wkf, Re, Gs, Gs
Wo, Wo, Wo, Wo, Wo, Ww^Wkf, Ww^Wkf, Ww^Bw\r, Gs^Ve, Gg, Gs^Fp, Gs^Fp, Gs^Fp, Gd^Edb, Gg, Gg, Gg, Gg, Ds^Ewsh, Wwr, Ww, Wo, Wo, Wwr, Gd^Ve, Wo, Wo, Ww^Wkf, Wwr, Re, Gs^Fp
Wo, Wo, Wo, Wo, Ww^Ewl, Ww^Ewl, Ds, Ds^Ewsh, Gg, Gs^Fp, Gs^Fp, Gs^Fp, Gs^Fp, Gs^Fp, Gs^Fp, Gs^Es, Gll^Es, Gg^Efm, Ds^Ewsh, Ww^Ewf, Ww, Wo, Wo, Wo, Gll, Wo, Wo, Ww, Wwr, Re, Gg^Es
Ww, Wo, Wo, Wo, Wo, Ww, Hhd^Em, Gs, Gs, Gs^Edb, Gs^Fp, Hhd^Fp, Hh, Hhd, Mm, Gs^Fp, Gs^Fp, Gg, Ds, Ww, Ww^Ewf, Wo, Wo, Wo, Hhd^Em, Wo, Wo, Wo, Ww, Re, Gg^Efm
Ww, Wwr, Ww, Ww^Wkf, Ww^Wkf, Ww, Wwr, Hh^Em, Hhd^Emf, Hhd^Em, Hh^Vhh, Hhd^Fp, Mm, Hhd^Fp, Hh^Dr, Hhd^Dr, Hh^Dr, Gs^Fp, Ds, Ww^Wkf, Ww^Wkf, Ww^Ewl, Wo, Wo, Hh^Vhh, Wo, Wo, Wo, Ww, Re, Gs^Es
Ww, Ww, Ww^Bw/r, Gll, Ww^Wkf, Ds^Ewsh, Gg^Ve, Hh, Mm, Mm^Xm, Mm, Hh, Hh, Hh^Em, Mm, Mm, Hhd^Fp, Gs^Fp, Gs^Fp, Wwr, Ww^Wkf, Wo, Wo, Wo, Wo, Wo, Wo, Ww, Wwr, Re, Gd
Ww, Hhd^Vhh, Ww, Gs, Gd, Gs, Gg, Gd, Hh, Mm, Mm, Mm, Hh^Vhh, Mm, Mm, Mm, Hh, Hh, Gs, Gg, Ww, Ww, Ww, Ww, Ww, Wo, Wo, Ww, Ww^Bw\r, Gs, Hh
Ww, Ww, Ww^Ewf, Wo, Gd, Gg^Efm, Gs, Gd, Gs^Fp, Hhd^Fp, Hhd^Fp, Hh^Em, Hhd^Em, Hhd^Emf, Mm, Mm^Xm, Mm, Hhd^Vhh, Hh, Gd, Ds^Esd, Ds, Ww, Ds, Ww, Wo, Ww, Ww, Re, Gs^Ve, Hh^Fp
Ww, Hhd^Em, Gs, Gg, Gs^Vh, Gg, Gd, Gs^Fp, Hhd^Fp, Hhd^Fp, Hh, Hhd^Dr, Mm, Mm, Mm, Mm, Hhd, Hhd, Hh^Fp, Gs^Fp, Gs^Fp, Gd, Rr, Ww, Ww, Ww, Ww, Re, Hh, Hh^Em, Hhd^Fp
Ww, Hh, Ds^Esd, Gg, Gg, Gs, Gs^Fp, Gs^Fp, Hhd^Fp, Hh, Mm, Mm, Mm, Hhd^Dr, Mm, Mm, Mm, Mm, Mm, Gs^Fp, Gs^Fet, Gs^Fp, Gd, Gg^Ve, Wwr, Ww, Ww^Bw/r, Ww^Bw/r, Gd, Hhd^Fp, Hhd^Fp
Wo, Ww, Hh, Hh^Dr, Gg, Gd, Gs, Gs^Fp, Gs^Fp, Hhd^Fp, Mm, Hh^Em, Hh^Dr, Hhd^Dr, Hh, Mm, Mm, Hhd^Em, Gs^Fp, Gs^Fp, Hh^Fp, Hh^Fp, Re, Ww, Wo^Bw/r, Wo^Bw/r, Ww, Re, Gs^Ve, Gs^Fp, Gs^Fp
Wo, Wo, Ww^Ewl, Wwr, Gs^Fp, Gg, Gs^Fp, Hh^Fp, Gs^Fp, Hh, Hh, Hhd^Em, Mm, Mm^Xm, Mm, Hh, Hhd, Hhd^Em, Hh, Gs^Fp, Hh^Fp, Gd, Re, Ww^Bw/r, Ww, Ww^Ewl, Ww, Ds, Gs^Fp, Gs^Fp, Gs^Fp
Ww, Ww^Wkf, Wwr, Gll, Gd^Es, Gd, Gs^Edb, Gs^Edb, Gs^Fp, Gd^Fp, Gd^Edb, Gd, Gs^Fp, Hh, Hh, Gs^Fp, Gd^Fp, Gs^Fp, Gs^Fp, Gs^Fp, Rb^Es, Rb, Gs, Ds^Ewsh, Ww, Ww, Ds^Esd, Ds^Ewsh, Gd, Gs^Fp, Hh^Fp
Ds, Gs^Ve, Gg^Es, Gll, Gd, Gs^Edb, Gs^Fp, Gs^Fp, Gs^Fp, Gg, Chr, Gs^Edb, Gs^Fp, Gd, Hhd, Gg, Rb, Chr, Rr, Rb, Gd, Gs^Edb, Ds, Ds^Ewsh, Ww, Ds, Gg, Gs^Fp, Gs^Fp, Hhd^Fp, Hh
Gg, Gs, Gs^Edb, Gg^Edb, Gs^Fp, Gs^Fp, Hh, Hhd, Gs^Fp, Chr, Chr, 2 Khr, Rr, Hh^Em, Hhd^Dr, Re, Gs^Fp, Re, Gs, Gs^Es, Ds, Gg^Efm, Ds, Wwr, Ww, Gs^Vh, Gg, Gs^Es, Hhd^Fp, Hhd, Mm
Gg, Gll, Gg, Gg^Ve, Gd, Gd, Gs^Fp, Hhd^Fp, Gs^Fp, Hh, Gs^Em, Chr^Edb, Chr, Rb^Edb, Re, Re^Es, Hhd, Hh, Gs^Fp, Gs^Fp, Wwr, Wwr, Ww, Ww, Wo, Wo, Ww, Gd, Hh, Mm, Mm
Gs^Fp, Gg^Efm, Gg, Gs, Gll^Es, Gs^Fp, Gs^Fet, Hh, Hh, Gd^Edb, Gg, Gs^Edb, Gg^Edb, Gd^Em, Gs, Gs^Edb, Gd, Mm, Mm, Ww^Ewl, Ww^Wkf, Ww^Wkf, Wo, Wo, Wo, Wo, Wo, Ww, Hhd, Mm, Mm^Xm
Gs^Fp, Gg, Gg, Gll, Gs, Gs^Fp, Hh^Fp, Hh^Fp, Gs^Fp, Hhd^Fp, Hhd^Fp, Hhd^Fp, Gg, Gg, Hhd^Fp, Gd, Hhd, Hhd, Hh, Ww, Wo, Wo, Wo, Wo, Wo, Wo, Wo, Wo, Hh, Mm, Mm
