Hh, Hh, Hh, Hh, Mm, Hh, Hh, Mm, Mm, Hh, Hh, Gg, Hh, Hh, Ww, Ww, Gg, Gg, Gs^Fp, Hh, Hh^Fp, Hh, Hh, Hh, Hh^Em, Hhd, Hh, Hh
Mm, Mm, Mm, Mm, Mm, Mm, Mm, Hh^Fp, Hh^Fp, Mm, Gs^Es, Gg^Efm, Ww, Hh, Gs, Ww^Ewl, Gs, Gs^Fp, Hh, Gs^Fp, Hh, Hhd, Gs^Fp, Hhd, Hh^Em, Hhd^Emf, Hhd^Em, Hh
Mm, Mm, Mm, Mm, Mm, Mm, Mm, Mm, Gs^Fp, Gs^Fp, Gg, Gg, Ww^Wkf, Hh, Wwf, Gg, Gg^Ve, Gd, Hh, Hh, Chr, Hh, Gs^Fp, Hhd, Hh^Fp, Hh^Em, Gs^Fp, Gs^Fp
Hh, Mm, Mm, Mm, Mm, Mm^Xm, Mm, Hh, Gs^Fp, Ww^Wkf, Ww^Ewf, Ww^Ewl, Wwr, Wwr, Wwf, Gg, Gs^Fp, Gd, Hh, Chr, 2 Khr, Chr, Hh, Gs^Fp, Gg, Gg, Hh^Fp, Hh^Fp
Hh, Hh, Hh, Hh, Gs, Mm, Gg^Efm, Hh, Gg, Ww^Wkf, Hh, Wwr, Wwf, Wwf, Gs, Gs^Fp, Hh, Hh^Fp, Hh, Chr, Chr, Chr, Hh, Gs^Fp, Hh, Hh, Hh, Hh
Hh, Hh, Wwf, Hh, Gs^Es, Gg, Wwf, Gg, Gg^Ve, Ww, Gg, Gg, Gs^Fp, Gd, Gs^Fp, Gs^Fp, Hh, Hh, Gs^Ecf, Gg, Gs, Gs, Gs^Fp, Gg, Gg, Gs, Gs, Gs
Wwf, Wwf, Gg^Efm, Wwf, Wwf, Wwf, Hh, Wwf, Wwf, Gg, Gs^Fp, Hh^Fp, Gs^Fp, Gs, Gs, Hh, Gg, Gg^Efm, Gg, Gg, Gs, Hh, Gs^Fp, Gs^Fp, Gs^Es, Hh, Hh, Hh
Gs^Fp, Gs^Fp, Wwf, Hh, Wwf, Hh, Wwf, Hh, Gg, Gs^Fp, Gg, Gs^Fp, Gs^Fp, Gs^Fp, Gg, Gg, Gs^Fp, Gs, Gg, Hh, Gg, Gs^Fp, Gs, Hh, Gs^Es, Gg^Ve, Gg, Gs
Gs, Gs^Fp, Gs, Wwf, Wwf^Es, Gs, Gd, Gd, Mm, Gg, Hh, Hh, Mm, Mm, Mm, Gs^Fp, Hh, Gs^Fp, Gs^Fp, Gg, Gg, Gs^Fp, Gs^Fp, Gs, Gg^Efm, Gg, Gs^Fp, Gg
Gg, Gd, Wwf, Gg, Hh, Gg, Gs, Hh, Hh^Fp, Mm, Mm, Hh^Fp, Mm^Xm, Mm, Mm, Mm, Mm, Hh^Vhh, Gs, Wwf, Wwf, Gs^Fp, Gg, Gg^Efm, Gs^Fp, Gg^Efm, Gs^Fp, Gg
Gs^Fp, Gs^Fp, Gg, Hh, Wwf, Wwf, Gs^Fp, Gs^Fp, Gs^Fp, Gs^Fp, Gs, Mm, Mm, Mm, Mm, Mm, Mm, Hh^Fp, Hh^Fp, Gg, Gs^Es, Wwf, Gg^Efm, Gg, Gs, Ww, Gs^Fp, Ww
Gs^Fp, Gg, Gs^Fp, Hh, Wwf, Gs, Ww^Wkf, Ww^Ewl, Ww^Wkf, Ww^Wkf, Ww, Gd, Mm, Mm, Mm, Mm, Mm, Mm, Mm, Gs^Fp, Gs, Wwf^Es, Gg, Gd, Gs^Fp, Gs^Fp, Gs^Fp, Ww
Gg, Gg, Gs^Fp, Hh, Wwf, Gg, Gg, Ww, Gg, Gg^Efm, Gg, Gs, Hh, Mm, Mm, Mm, Mm, Hh, Gs^Fp, Gs, Gg, Wwf, Wwf, Gd, Gd, Gs^Fp, Gg, Gs^Fp
Gg, Gs, Gs^Fp, Gs^Fp, Gs^Fp, Wwf, Gg, Ww, Gs, Ww^Wkf, Gg, Hh, Gg, Mm, Mm, Mm, Hh^Fp, Hh^Fp, Gs^Fp, Ww, Gg^Efm, Gg, Wwf, Wwf, Gg, Gg, Ww, Gg
Hh, Gs, Gs, Gg, Gs, Gs^Fp, Wwf, Gd, Gd, Ww^Wkf, Ww^Ewf, Gg, Mm, Mm^Xm, Mm, Mm, Mm, Hh^Fp, Hh^Fp, Gg, Gs, Wwf, Wwf, Gs, Gs, Hh, Hh, Hh
Gs^Fp, Hh, Gg^Efm, Gg^Ve, Gg, Gd, Gd, Gd, Gg, Hh, Ww, Gs, Hh, Mm, Mm, Mm, Mm, Mm, Mm, Hh, Gd, Wwf, Wwr, Wwf, Wwf, Wwf^Es, Wwf, Wwf
Hh, Gs^Fp, Hh, Gg, Gs^Fp, Gg, Hh, Gg, Gg, Hh, Hh, Gs, Gg, Gs^Fp, Hh^Fp, Mm, Mm, Mm, Mm, Gs, Gs, Wwf, Wwr, Wwr, Wwr, Wwf, Hh, Hh
Hh, Gs^Fp, Gs^Fp, Hh^Fp, Gs^Fp, Gs, Hh, Hh^Fp, Gg, Gg^Efm, Gg^Efm, Gg^Efm, Hh, Gs^Fp, Gs^Fp, Hh^Vhh, Gs^Fp, Mm, Gg, Hh, Gg, Gs, Ww, Ww, Ww^Wkf, Hh, Ww^Wkf, Ww^Wkf
Hh, Gg, Gg, Gs^Fp, Gs, Gs, Gg^Ve, Gg, Gs, Gs, Gs, Gg, Gg, Gg, Gs, Gs^Fp, Gs, Gg, Gs^Fp, Gg, Ww^Ewf, Ww, Hh, Hh, Hh, Ww^Wkf, Hh, Hh
Gg, Gg, Hh, Hh, Hhd, Hh, Gg, Gg, Gd, Gs^Fp, Hh, Hh^Em, Hhd^Emf, Gg, Gg, Gs, Gs^Fp, Gg, Ww^Wkf, Gg, Ww^Ewl, Wwr, Gg, Ww, Ww, Ww^Ewl, Ww, Ww
Gg, Hh, Gs^Fp, Hh^Fp, Hh, Gg, Hh, Hh, Hh, Gd, Hh, Hhd^Em, Hhd^Em, Hh, Gg, Gs^Fp, Gs^Fp, Hh, Ww^Wkf, Wwr, Wwr, Wwr, Gg^Efm, Gg, Gd, Ww, Gs, Gs
Hh, Hh, Gs^Fp, Hh^Fp, Hh, Gg, Chr, Chr, Chr, Gg, Gs^Ecf, Hh, Gg, Gg^Efm, Gg, Gs, Gd, Hh, Hh, Ww^Wkf, Ww, Ww, Gg, Gs^Es, Gs^Fp, Gs, Gs^Fp, Gs^Fp
Hh^Fp, Gs^Fp, Gs^Es, Gs^Fp, Gs^Fp, Gs, Chr, 1 Khr, Chr, Gg, Gg, Gg, Gs^Es, Gg, Hh, Gg, Gg, Gg^Ve, Gg, Gs, Gs^Fp, Gg, Gg^Ve, Gs, Gs, Gs^Fp, Hh, Gs^Fp
Hh, Gs, Gg, Gd, Gs, Gs, Gg, Chr, Gs^Fp, Gg, Hhd, Hhd, Gs^Fp, Gs^Fp, Mm, Mm^Xm, Mm, Gg, Hh, Gg, Gs^Fp, Gg, Gg, Gg, Hh, Hh, Gs, Hh
Hh, Hh, Gs^Fp, Hh, Gs^Fp, Gs^Efm, Hh, Gg, Gg, Gg, Hhd, Gs^Fp, Hh, Hh^Fp, Mm^Xm, Mm, Mm, Mm^Xm, Mm, Hh^Fp, Hh, Gs^Fp, Gd, Gg, Gg, Gg, Gg, Gs
Hh, Hh, Hh, Gs^Fp, Hh, Gs^Efm, Gs^Fp, Hh^Fp, Gs^Fp, Gs^Fp, Hhd, Gs^Fp, Hh, Mm, Mm, Mm, Hh, Mm, Hh^Fp, Hh^Fp, Hh, Hh, Hh, Gs, Gs, Gg^Efm, Gg^Efm, Gg^Efm
