Gs, Gs, Gs, Gs, Gs, Gg, Gg, Gg, Gs, Gs, Gg, Gg, Gg, Gg, Gg, Gg, Gg, Gg, Gg, Gg, Ww, Wo, Wo, Wo, Ds, Gd, Gd, Gg, Gs, Gs, Gg^Efm, Gs, Gs, Gs, Gd, Gs, Gg, Gg, Gs, Gs, Gs, Gs, Gs, Gg, Gg, Gg, Gg, Gg
Gs, Gs, Gs, Gs, Gs, Gg, Gg, Gs^Fp, Gs^Fp, Gs, Gg^Efm, Gg, Gg, Gg, Gs, Gg, Gg^Efm, Gs, Rp, Gd, Ww, Wo, Wo, Wo, Ds, Ds, Gs, Gd, Gs, Gg^Efm, Gg^Efm, Gs, Gs, Gd, Gd, Gg, Gg, Gg, Gs, Gs, Gs^Fds, Gs, Gg, Gs, Gs, Gs, Gs, Gg
Gs, Gs, Gs, Gs, Gs, Gg^Edt, Gs^Fp, Gs^Fp, Gs^Fp, Gs^Fms, Gg^Fet, Gg, Gg, Gs, Gs, Gs, Gs, Rr, Rr, Rp, Ww, Wo, Ds, Ww, Ds, Gd, Gd, Gs, Gs, Gs, Gs^Fp, Gs, Gs, Gs, Gg, Gg, Gs, Gs, Gs, Gg^Efm, Gs, Gs, Gg, Gg, Gs, Gd, Gs, Gs
Gg, Gd, Gg, Gg^Vhr, Gg, Gs, Gs^Fp, Gd^Vo, Gg, Gs^Fp, Gs^Fds, Gs^Fms, Gs, Gs, Rp, Gg, Gs, Rr, Gs^Ve, Rp, Ww^Bw\, Ww, Ds, Ds, Gs, Gd, Gs, Gs, Gg, Gd^Vo, Gg, Gs^Fp, Gs, Gs, Gg, Gs, Gs^Es, Gs, Gs, Gs, Gs, Gs, Gs, Gs, Hhd^Fp, Gd^Edp, Gs, Gs
Gg, Gg, Gg^Efm, Gg^Efm, Gg^Efm, Chr, Chr^Edt, Gs, Gs, Gd, Gs^Fds, Gs^Fms, Gs, Gs^Es, Gd, Gs, Wo, Ww, Wwr, Ww^Bw\, Rr, Gd, Gg, Gs, Gs, Gs, Gs, Gs, Gs, Gs^Fds, Gs, Gs, Gs, Gs, Gs, Gg^Es, Gs, Gs^Es, Gs, Gs^Fds, Gs, Gs, Gs, Gs, Hh, Gd, Gd, Gs
Gg, Gg, Gs, Gd, Rp, Chr, 1 Khr, Chr^Edt, Gs^Edt, Gs^Edt, Gs, Gs, Gs, Gd, Gd, Ww, Ww, Wo, Wwr, Wwr, Gs, Rr, Rp, Gg, Gg, Gs, Gs, Gs, Gg, Gs, Gd, Gs, Gs, Gs, Gg, Gs, Gg, Gs, Gs, Gs, Gs^Edt, Gs^Edt, Gs^Edt, Gs, Hh, Hhd^Fp, Gs, Gs
Gg, Gs, Gd^Em, Gs, Rp, Chr, Gs^Fds, Chr^Edt, Gd, Gd, Gs, Gg^Edt, Gs, Hhd, Hhd^Vhhr, Gg, Gs, Ww, Ww, Gg, Gd^Vo, Rr, Rr, Gg, Gs, Gd, Gd, Gg, Gs^Fds, Gg, Gd, Gs^Edb, Gg, Gs, Gg, Gg, Gg^Edt, Gs^Edt, Gs, Gs, Gs^Edt, Gg, Gs, Gs, Gs, Hhd^Em, Hhd^Em, Hh^Fp
Ds, Ds, Ds, Gs, Gs, Rp, Gd, Gd, Gs^Fp, Gs^Fp, Gg, Gg, Hhd, Hhd, Gg, Gg, Ww^Bw\, Ww, Gg, Gg, Gs, Gs, Rp, Rr^Es, Gs^Edb, Gs^Edb, Gs^Edb, Gg, Gd, Gs, Gs, Gs, Gs, Gg, Gd^Edt, Gs^Edt, Gs, Gs, Gd, Gs, Gg^Es, Gg, Gs, Gs, Hh, Gs, Hhd^Em, Gs
Ww, Ww, Wo, Ds, Gs, Gg^Edt, Gs, Gs, Gs, Gg, Hhd^Em, Hhd^Em, Gs, Gd, Wwr, Ww, Ww, Gs, Gg, Gd, Gs^Fp, Gs, Gs, Rr, Gg, Gg, Gg, Gs^Edb, Gd, Gd^Vo, Gg, Gs, Gs^Edb, Gs^Edb, Gs^Edb, Gs, Gs, Gd, Gs, Gd, Gd, Gg, Gg^Edt, Gs, Gs, Gs, Gs, Gs
Ww, Ww, Ww, Wo, Ww, Gs, Wwr, Ww, Hhd, Hhd, Ds, Ww, Ww, Ww, Wwr, Gs, Wwr, Gg, Gg, Gg, Gs, Gs, Re, Re, Re, Gs, Gg, Gd, Gg, Gs, Gg, Gs^Edb, Rp, Co, Co, Gd, Gd, Gd^Vo, Gs, Gs, Mm, Gd, Gg^Edt, Gg, Gs, Gs^Efm, Gs^Efm, Gs^Efm
Ds, Ds, Ds, Ww, Ww, Ww^Bw|, Wwr, Wo, Gd, Gs, Ww, Ww, Gs, Gd, Gs, Ww, Ww, Gs, Gd, Gg, Gg, Gg, Gg^Efm, Gg, Re, Rd, Re, Gg, Gs, Gg, Rp, Rp, Rp, 2 Ko, Co, Co, Gd, Gg, Hh, Gs, Hh, Gs, Gs, Gs, Gs^Fp, Gs^Fp, Gg^Fet, Gs^Fds
Gg^Efm, Ds, Ds, Ds, Ds, Gs, Gs, Ww, Ww^Bw|, Ww, Gg, Gs, Gs, Gg, Gg^Vhr, Gs, Gs, Ww, Wwr, Gs, Gs, Gs, Mm, Gg^Efm, Gg^Efm, Gd, Gd^Es, Re, Gs, Gd, Gs, Gs^Ecf, Gs^Edb, Co, Gs, Co, Gs^Edb, Gd, Gg, Hhd^Em, Hh, Gs, Hh^Fp, Gs, Gs, Gs, Gs, Gs
Gg, Gg^Efm, Gs, Gs, Gs, Gs, Gg, Gg, Gd, Gg, Gg, Gg^Efm, Gd, Gg, Gg, Gg, Gs, Gs, Gs, Wo, Mm, Hhd, Hh, Hh, Gg^Efm, Gg, Gd, Re, Gg, Gs, Gs, Gs^Edb, Gs^Edb, Gd, Gs, Gs^Edb, Gs^Edb, Gd, Gs, Gg, Gg^Efm, Hh^Fp, Gg^Efm, Gs, Gs, Gs, Gs, Gs
Gg, Gg, Gs, Gs, Gg, Gg, Gg, Gd^Vh, Gg, Gg, Gs, Gs, Gs^Fp, Gg, Gs^Efm, Gg, Gs, Gs, Hh^Em, Ww, Hhd, Hhd, Gs^Fp, Gg^Efm, Gs^Fp, Gs^Fds, Gg, Re, Re, Gg, Gd, Gs, Gs, Gd, Gg, Gg, Gs, Gs, Gs, Gg, Gg, Gg^Efm, Gs, Gs, Gs, Gd^Em, Gs, Gs
Gs, Gs, Gs, Gs^Em, Gs^Edt, Gg, Gs, Gs, Gs^Edt, Gg^Efm, Gs, Gd^Em, Gs, Gs, Gs, Gs, Gs, Gs, Gg^Efm, Ww, Ww, Gs^Fp, Gs^Fp, Gg^Fet, Gs^Fds, Gs^Fds, Hh, Gg^Efm, Re, Gg, Gs, Gs^Edb, Gs, Gs, Gg, Gs^Edb, Gs, Gs, Gs, Gd^Es, Gs, Gs, Gs, Gs, Gs, Gs, Gs, Gs
Gs, Gs, Gd, Gs, Gs, Gs^Edt, Gs^Edt, Gs^Edt, Gs, Gs, Gs, Gs, Gs, Gs, Gs, Gs, Gs, Gd, Gs^Fp, Gs^Fms, Ww, Gs^Fp, Hh, Gs^Fp, Gs, Hhd, Hh, Mm, Re, Gs^Fds, Gs, Gs, Gs, Gs, Gg, Gg, Gg, Gs, Gs^Edt, Gs, Gs^Fp, Gs^Fp, Gs, Gs, Gg, Gs, Gs, Gs
Gs, Gs, Gd, Gs, Gs, Gg^Efm, Gg^Efm, Gs, Gd, Gs, Gs, Gd, Gs, Gd^Vo, Gs, Gs^Edp, Gs, Gs^Efm, Gs^Fds, Gs^Fms, Hh^Em, Ww, Gs^Fms, Gs^Fp, Gd, Hh, Gs, Gd, Gd, Re, Re^Es, Gs, Gs, Gs, Gs^Edp, Gs, Gs, Gs, Gs^Edt, Gs^Edt, Gs, Gs^Fp, Gs, Gs, Gs, Gs, Gs, Gs
Gs^Edt, Gs, Gs, Gs, Gs, Gs, Gg^Efm, Gs, Gs, Gs, Gd^Dr, Gd, Gg^Es, Gs, Gs^Edt, Gs, Gs, Gs, Gs, Gs^Fp, Gs^Fp, Ww, Gs^Fp, Gs^Fp, Gg^Vh, Gd, Gs, Gg, Gg, Gg^Vhr, Gs, Re, Rd, Gs^Edt, Gs, Gs, Gd^Vo, Gs, Gs, Gs, Gs, Gs, Gd, Gs, Gs, Gs^Edt, Gd^Em, Gd
Gs^Edt, Gs^Edt, Gs, Gg^Ve, Gs, Gg^Efm, Gs, Gs, Gs, Gs, Gd, Gd, Gg, Gs^Edt, Gs^Edt, Gs^Edt, Gs^Edt, Gs^Es, Gd^Edt, Gs, Gs, Ww, Gg, Gg, Ww, Ww, Ww, Gs, Gg, Gs, Gg, Gs^Efm, Re, Gs, Gs, Rp, Rp, Gs, Rp, Rp, Rp, Gs, Gd^Vo, Gs, Gs, Gs^Em, Gd^Es, Gs^Em
Gs, Gs, Mm, Gs, Hh, Gs, Gs^Edt, Gs, Gs, Gs, Gs, Gd, Gg, Gs^Edt, Gg^Efm, Gs^Edt, Gg, Gs, Gs, Gs, Gg, Ww, Ww, Ww, Wo, Wo, Ww, Gg, Gg^Efm, Gg, Gg, Gs, Re, Gs, Gg, Gs, Gg, Rp, Gs^Edt, Co, Rp, Gd, Gs^Edt, Gs^Edt, Gg^Edt, Gd^Em, Gs, Gs
Mm, Hh, Mm, Mm, Hhd^Em, Mm, Hh, Gs, Mm, Mm, Gs, Mm, Hhd, Gg^Efm, Gg^Ve, Gg^Efm, Gg^Efm, Gg, Gg, Gg, Gg, Ww, Ww, Wo, Wo, Ww, Gs, Gg, Gg, Gg, Gs, Gs^Efm, Re, Gs, Gg, Gg, Gg^Edt, Gs^Edt, Co, Co, Co^Edt, Rp, Gs, Gd^Edt, Gs, Gs, Gs, Gs
Ww, Mm, Mm, Hh, Mm^Xm, Mm, Mm, Hhd^Em, Hh, Hhd^Em, Hhd^Em, Gs, Hhd, Mm, Hh, Mm, Hh, Gs, Gs^Em, Gg, Gg, Gg, Ww, Wo, Ww, Ww, Gs, Gg, Gd^Dr, Gd^Em, Re, Re, Gd^Vhr, Gd, Gd, Gg^Edt, Gg, Gg^Edt, Co^Edt, 3 Ko, Gs, Gs^Edt, Gs^Ecf, Gs, Gs, Gs, Gd, Gs
Ww, Ww, Ww, Mm, Mm, Mm, Hhd^Em, Hhd^Em, Mm, Hh, Gs, Gs, Hhd, Hh, Hhd, Hh, Hh, Hh, Hh, Gs, Gs, Gg, Gg, Ww, Gd^Edt, Ww, Ww, Gs, Re, Re, Gd, Gd, Gs, Gd, Gs, Gll, Gs, Gs, Gs, Co, Gg, Gs, Gs, Gs, Gs, Gs, Gd, Gs
Gg, Ww, Gs^Em, Gs, Gg, Hh, Gd^Dr, Hh, Mm, Mm, Gg, Mm, Hhd, Hhd, Hhd, Hhd, Hh, Mm, Hhd, Hh, Gs, Mm, Gg, Gd^Edt, Gg^Efm, Gs, Ww^Bw/, Re, Gs, Gg, Gg, Gs, Gs, Gs, Gs, Gs, Gs, Gs, Gd^Em, Gs, Gs, Gs, Gs, Gs, Gd, Gs, Gs, Gs
Ww, Ww^Bw\, Gs, Gd, Gs^Ve, Gg, Gg, Mm, Gs, Gs, Hh, Mm, Mm, Mm, Hhd, Hhd, Hh, Hhd, Mm, Hhd, Mm, Mm^Xm, Re, Re, Re, Re, Ww, Gs, Gs, Gs, Gd^Es, Gg, Gg, Gs, Gs, Gs, Gs, Gs^Edt, Gs^Edt, Gs, Gs, Rp, Rp, Rp, Gs, Gg^Efm, Gg^Efm, Gs
Ww, Ww, Ww, Gg, Gg^Edt, Gg, Gs, Mm, Gs, Hhd, Hhd, Hh, Hhd, Hhd, Hh, Hh, Gg^Efm, Mm, Gs^Efm, Gs^Efm, Re, Re, Gs, Gg, Gs, Gs, Ww, Gs, Gd^Vo, Gs, Gs, Gg, Gs, Gd^Es, Gs^Em, Gs, Gs, Gs, Gs, Gs, Rp, Rp, Gg^Efm, Gg^Efm, Hh^Em, Gs^Fp, Gs, Gg^Efm
Hh, Ww, Mm, Gg, Gg^Edt, Gg^Edt, Gg^Edt, Gs, Hhd, Hhd^Vhhr, Mm, Hhd, Gg, Gs, Gs, Gg, Gg^Efm, Gs^Efm, Gs, Gg, Gs, Gs, Gs, Gs, Gs, Gd, Ww, Ww, Ww, Gs, Gs, Gg, Gs, Gs, Gs, Gs, Gs, Gd^Vhr, Gg, Gs, Rp, Gg^Edt, Gg^Efm, Gs^Fp, Gs, Hh^Em, Gs, Gs
Hh^Fp, Hh, Hh, Hh^Fp, Hh, Hh, Gg^Edt, Hhd, Mm^Xm, Mm^Xm, Mm, Gg, Mm, Gg, Gg^Efm, Gg, Gs, Gs, Gd^Es, Gs, Gg, Gg, Gg, Gg, Gs, Gs, Gs, Gd, Ww, Ww, Ww^Bw|, Gs, Gg, Gd^Vo, Gs, Gd, Gs, Gs, Gs, Gs, Gs, Gs, Gg^Efm, Gs^Fp, Hh^Em, Hh^Fp, Hh, Gs^Fms
Hh, Hh^Fp, Mm, Mm, Gs^Edt, Gs^Edt, Mm, Mm, Mm, Mm, Gs, Mm, Mm, Gg^Efm, Hh, Mm, Mm, Gs, Gs^Fp, Mm, Gg, Gg, Gg, Gg, Gd, Gs, Gd, Gd, Gd, Ww, Gs, Ww, Ww, Ww, Ww, Gs^Edt, Gs^Edt, Gs, Gd^Es, Gs, Gs, Gd^Es, Gg^Efm, Gs, Hh^Fp, Hh^Fp, Gs^Fp, Gg^Efm
Gs, Hhd, Hh, Gs^Edt, Hh, Hhd, Gg^Efm, Mm, Gs, Gs, Gg, Mm, Gg, Gg^Efm, Gg, Gs^Fp, Gg, Hhd, Gs^Fp, Gs, Mm, Gg, Gs^Fp, Gg, Gs, Gs, Gd, Gd, Gd, Gs, Gd, Gg, Ww, Wo, Ww, Ww, Ww, Gs^Edt, Gs, Gs, Gs, Gs, Gs, Gs^Fp, Hh^Fp, Hh, Gg, Gs
Hh, Gg, Gg, Gg, Gs, Gs, Gs, Gs, Gs, Gs, Gg, Gg, Gg, Gg^Efm, Gs^Es, Gg, Gs, Gs^Fp, Gs, Gs, Gg^Efm, Gg^Ve, Gg^Efm, Gs, Gd, Gs, Gs, Gg, Gs, Gd, Gs, Gs, Ww, Wo, Wo, Ww, Ww, Ww, Gd, Gg^Es, Gg, Gs^Em, Gg, Gs^Fp, Gg, Hh, Gg, Gs^Fms
Hh, Gg, Gd, Gs, Gd, Gs, Gd^Vo, Gs, Gs, Gd, Gg, Gs, Gg, Gg^Efm, Rp, Gs, Gg^Edt, Mm, Gs, Gg^Efm, Gs, Gg^Efm, Gs, Gs, Gs, Gg, Gg, Gg, Gs, Gs, Gd, Gs, Ww, Ww, Wo, Wo, Ww, Ww, Ds, Gd^Es, Ds, Gs, Ds, Gg^Esd, Ds, Ds, Ds, Gg
Gs, Gs, Gs, Gd^Es, Gg^Es, Gs, Gs, Gs, Gg, Gg, Gg, Gd^Vhr, Gg^Efm, Gg^Efm, Rp^Edt, Gs, Gs^Edt, Gs^Edt, Gs, Gs, Gs, Gs, Gs^Edp, Gs, Gs, Gs, Gs, Gs, Gs, Gs^Edb, Gs, Gs, Gs, Ww, Ww, Ww, Ww, Ww, Ds, Gs, Gs, Gg^Edt, Gs, Ds, Ds^Esd, Ww, Ww, Gd^Em
Gs, Gs, Gs, Gd^Es, Gs, Gs, Gs, Gs, Gs, Gs, Gs, Gg^Efm, Gs^Ecf, Gd, Co, Co^Edt, Co, Rp, Rp, Gd, Gd, Gs, Gs, Gs, Gd, Gd, Gs, Gs, Gs, Gs, Gg^Esd, Gs, Gg^Esd, Gs, Gd, Ds, Ds, Ww, Ds, Ds, Ds^Esd, Gg^Edt, Gs, Gs^Esd, Gs^Em, Ds, Ds, Ds
Gg, Gs, Gd, Gd, Gs, Gs, Gs, Gs, Gs^Edt, Gg, Gs, Gs, Gg, Gd, Mm, 4 Ko, Co, Co^Edt, Gd^Edt, Gs^Edt, Gs^Edt, Gs^Edt, Ds, Ds, Gd, Ds, Gs, Gs, Ds^Esd, Gg^Esd, Ds, Ds^Esd, Gg, Gg, Gs, Ds, Ds, Ww, Ds, Ds^Esd, Gs^Edt, Hhd^Em, Gs, Gs, Ds, Ds, Gs, Gs^Efm
Gg, Gs, Gs, Gs, Gg^Efm, Gg^Efm, Gg^Efm, Gg, Gg^Efm, Gs, Gs, Gs, Gd, Gd^Edt, Gd^Edt, Co, Gg, Gd^Edt, Gs, Gg, Gg, Gs, Gs, Gs, Gs, Gs, Ds, Gs, Ds, Ds, Gg^Efm, Ds, Gs, Gs^Fp, Gs^Fp, Gs^Fms, Ds, Ds, Ds, Ds^Esd, Gs, Gs, Ds, Gs^Em, Gd, Ds, Gs^Esd, Ds
Gg, Gs, Gs, Gg^Efm, Gg, Gg^Efm, Gg, Gg^Efm, Gs, Gg^Edt, Gs, Gd^Vo, Gg, Gg^Efm, Gg, Gg, Rp, Gs, Gs, Gg, Rp, Gs^Fp, Ds^Esd, Gs, Ds, Ds, Gs^Es, Ds, Gs, Ds, Gg^Efm, Ds, Ds, Ds, Ds, Gg^Efm, Ww, Ds, Gs, Ds^Esd, Gll, Ds, Ww, Ds, Gg, Gg, Gg, Ds
Gg, Gs, Gs, Gs, Gs, Gg^Efm, Gs, Gs, Gs, Gd, Gs, Gs, Gs, Gg, Gs, Gs, Gd^Vo, Rp, Rp, Rp, Ww, Wo, Ww, Gs, Ds, Gs^Es, Ds, Gs^Es, Mm, Gs^Fms, Gs^Fp, Gs^Fp, Mm, Gs^Fp, Gs^Fp, Ds, Gs^Fp, Gg, Hh, Hh, Gg, Gg, Ds, Ds, Ds, Ds, Gg, Gs
Gg, Gg, Gs, Gs, Gs, Gs, Gs, Gs, Gg, Gs, Gs, Gd, Gs, Gs^Edp, Gs, Rp, Gs, Rp, Gd, Ds, Ds, Ww, Ds, Ww, Ds, Ds, Gs^Efm, Gs^Fp, Gs^Fp, Gs^Fms, Hh^Fp, Gg^Efm, Hh, Gs^Fp, Gg^Efm, Gg, Ds, Gs^Fp, Mm^Xm, Gs^Fp, Gs^Fms, Gs^Fms, Ds, Gs^Efm, Gd, Ds, Ds, Ds
Gs, Gs, Ds, Gd, Gd, Gs, Gs, Gg, Gs^Esd, Gg, Gg, Gs, Ds, Gs, Gs, Gs, Ds, Gs, Gs, Ds, Ds, Ds, Ds, Ds, Ds^Esd, Gs^Efm, Gs, Ds, Ds, Gg^Fet, Hh, Hh^Fp, Gg, Ds, Hhd^Em, Hhd^Em, Ds, Ww, Gg^Efm, Gg^Efm, Gg^Efm, Gg^Efm, Gs, Ds, Ds, Ds, Ds^Esd, Ds
