Gd, Gd, Gd, Gg, Gg, Gs, Gs, Gg, Gs, Gg, Gg, Gg, Gs, Ds, Ds, Ds, Gd, Gd, Gg, Gg, Ww, Wo, Wo, Wo, Ds, Gs, Gs, Gg, Gd, Gs, Gs^Fp, Gs^Fp, Gs^Fp, Gs^Fp, Gs^Fp, Gs^Fp, Gd, Gg, Gg, Gg, Gs, Gd, Gd, Gs, Gs, Gg, Gll, Gs
Gg, Gg^Efm, Gs, Gs, Gll, Gs, Gs^Edt, Gs^Fp, Gs^Fp, Gs^Efm, Gs^Efm, Gg, Gll, Gs, Gs, Gd, Gg, Gs^Fp, Rp^Efm, Gs^Fp, Ww, Wo, Wo, Wo, Ds, Ds, Gg, Gg, Gg, Gd, Gs, Gs^Fp, Gg^Fet, Gs^Fp, Gs^Fp, Gd, Gg, Gd, Gs, Gg, Gs^Fp, Gs, Gg, Gd, Gs, Gg, Gg, Gs
Gs, Gs, Gs, Gd, Gd, Gd^Edt, Gs^Fp, Gs^Fp, Gs^Fp, Gs^Fms, Gg^Fet, Gs^Efm, Gd, Gd^Edb, Gg, Gg^Efm, Gs^Fp, Rr, Rr, Rr, Ww, Ww^Ewl, Ds, Ww, Ds, Gs, Hh^Em, Mm, Hhd, Gs, Gg, Gs^Fp, Gs^Fms, Gs^Fms, Gs^Fms, Gs, Gg^Efm, Hh, Gd, Gg, Gg, Gs, Gg^Efm, Gg^Efm, Gd, Gs, Gs^Edb, Gg^Efm
Gs, Gd^Edb, Gg^Edb, Gg^Vh, Gs, Gd^Edt, Gs^Fp, Gg^Ve, Gd, Gs^Fp, Gs^Fms, Gs^Fms, Gs, Gs^Edb, Gg, Gg, Gd, Rr, Rr^Es, Rr^Es, Ww^Bw\, Ww, Ds, Ds^Es, Gd^Es, Gll, Gll, Hh^Fp, Gs, Gg, Gg, Gg^Efm, Gg, Gs, Gs, Gs, Gg^Efm, Hh^Fp, Hhd, Gd, Gg, Gg, Gs, Gd, Hhd^Fp, Gs, Gs^Es, Gs^Edb
Gs, Gs^Edb, Gg, Gg, Gs^Edb, Ce, Ce, Gs, Gd, Gd, Gs^Fp, Gs^Fp, Gg^Efm, Gg^Efm, Gg, Ds, Ww, Ww, Ww, Ww^Bw\, Rr, Gs, Gs, Gd^Es, Gd, Gg, Gll, Gs, Gs, Gg^Vo, Gg, Gg, Gs, Gll, Gs, Gg^Es, Gg^Es, Gg^Es, Gg, Gg, Gll^Gvs, Gll^Gvs, Gll^Gvs, Gs, Hh, Gs^Es, Gs^Es, Gs
Gg, Gg, Gll, Gs^Fp, Gs^Fp, Ce^Edb, 1 Ke, Ce^Edb, Gs^Edb, Gd^Edb, Gs, Gg, Gg, Gg, Gs^Ve, Ww, Ww, Ww^Ewl, Ww^Ewl, Ww, Ds, Rr, Rr, Gll, Gs^Efm, Hhd, Gg, Gg, Gg, Gg, Gll^Gvs, Gll^Gvs, Gll^Gvs, Gs, Gg^Vo, Gd, Gd, Gs, Gs, Gs, Gs, Gll^Gvs, Gs, Gs, Hhd, Hh^Fp, Gd, Gd
Gd, Gs^Efm, Gg, Gll, Gs^Fp, Gs^Fms, Ce^Edb, Ce, Gs^Fms, Gs^Fms, Gs, Gg, Gs^Edb, Hh^Dr, Hhd, Gg, Ds, Ww, Ww, Ds, Gs, Rr, Rr, Gs^Dr, Gs, Gs, Gd, Gd, Gs^Fp, Gg, Gs, Gll^Gvs, Gs, Gs, Gg, Gs^Edb, Gd^Edb, Gs, Co, Gd, Gd^Edb, Gs, Gs^Edb, Gll, Gll, Hhd, Hhd, Hhd^Fp
Ds, Ds, Ds, Gs, Gs^Edb, Gs^Fp, Gs^Fp, Gs^Fms, Gs^Fp, Gs^Fp, Gd^Edb, Gd^Edb, Hh^Fp, Hh^Em, Gs, Ds, Ww^Bw\r, Ww, Ds, Ds, Gg, Gd, Rr, Rr, Gs, Gd, Gg, Gs^Fp, Gg^Efm, Gs^Fp, Gs, Gs, Gg, Gg^Efm, Gs, Gs^Edb, Hhd, Gd^Edb, 2 Ko, Co, Co^Edb, Co^Edb, Gd^Edb, Gll, Hh, Gd, Hh, Gg
Ww, Ww, Ww, Ds, Gd, Gs^Edb, Rr, Re, Gs, Gs, Hhd^Em, Hhd^Fp, Gll, Gll, Wwr, Ww, Ww, Re, Gs, Gd, Hh, Gd, Gd, Rr, Gd^Ve, Gg, Gg, Gs, Gs^Fms, Gg^Efm, Gs, Gs^Es, Gg, Gg^Efm, Gg^Efm, Gg, Gs, Gd, Co, Co, Co, Gd, Gg, Gg, Gd, Gd, Gg, Gg
Ww, Ww, Wo, Ww, Ww, Re^Es, Wwf, Ww, Hh, Hh, Ds, Ww, Ww, Ww, Wwr, Wwf, Wwr, Re, Gd, Gg, Gs, Gs, Re, Re, Re, Gd, Gs, Gg, Gg, Gs, Gs^Edb, Gd, Hh, Gg, Gs, Gs, Gs, Gs^Edt, Gs^Edt, Gs^Dr, Mm, Gd, Gg, Gg^Efm, Gg, Gg, Gs, Gd
Ds, Ds, Ds, Wo, Ww, Ww^Bw|, Ww, Ww, Gs^Ve, Gs, Ww, Ww, Ds, Ds, Ds, Ww, Ww^Wkf, Re, Re, Gg, Gd, Gs, Gs, Gs, Re^Es, Re^Es, Re^Es, Gs, Gs, Gg, Gd, Gd^Edb, Gs^Ve, Gg, Gll^Gvs, Gll^Gvs, Gll^Gvs, Gs, Gs^Ecf, Gs^Edt, Hh^Dr, Gs, Gs, Gg, Gs^Fp, Gs^Fp, Md, Gs^Fms
Gg, Ds, Ds, Ds, Ds, Re, Ds, Ww, Ww^Bw|, Ww, Rr^Es, Ds, Gs, Gs, Gs^Vh, Ds, Ds, Ww, Wwr, Re, Re, Gg, Md, Gg, Gg^Efm, Gs, Gs, Re, Gs, Gg, Gs^Fms, Gs^Edb, Gs, Gg, Gd, Gll^Gvs, Gd, Gs, Gs, Hh, Hhd, Gs, Hh^Fp, Gg, Gd, Gs, Hh, Hh
Gg, Gs^Fp, Gg, Gg, Gg, Gs, Gs, Re, Re, Ds, Rr^Es, Gd, Gd, Gg, Gg^Efm, Gd, Gd^Fp, Ds, Ds, Ww, Mm, Hh^Fp, Hh, Hh, Gg, Gg, Gs, Rr, Gll, Gg^Efm, Gg, Gs, Gg, Gg, Gg, Gd, Gs, Gs, Gll, Gll, Gll, Hhd^Fp, Gg, Gg^Efm, Gg, Gll, Gg, Gs
Gd, Gd, Gd^Edt, Gd^Edt, Gs, Gg^Efm, Gg^Efm, Gs^Vh, Gg, Re, Gs, Gd, Gg^Efm, Gg, Gs, Gg, Gg, Gs^Fp, Hh, Ww, Hh, Hhd, Gs^Fp, Gs, Gg^Fet, Gs^Fp, Gs, Rr, Rr, Gg, Gll, Gg, Gg, Gs^Fms, Gg, Gg, Gg, Gs^Efm, Gg^Efm, Gg, Gs, Gg, Hh, Gg, Gg, Gll, Gg, Gs
Mm, Hh, Hhd^Dr, Hh^Em, Mm, Gs^Edt, Gs^Efm, Gg, Gs, Rr, Gs, Gg, Gs, Gs, Gll, Gd, Gg^Edt, Gs, Gg^Efm, Ww^Wkf, Wo, Gs^Fp, Gs^Fp, Gs^Fp, Gs^Fp, Gs^Fp, Hhd, Gll, Re, Gs, Gs, Gs, Gd, Gd, Gd, Gg^Vo, Gs, Gg, Gg^Efm, Gg, Gs, Gs, Hhd^Emf, Hhd^Em, Hh^Em, Gg, Gd, Gg
Mm, Mm, Mm, Mm, Mm, Gd^Edt, Gs^Fms, Gs, Gs, Re, Gg^Efm, Gg^Efm, Hh^Emf, Md, Md, Gd^Edt, Gd^Edt, Gs, Gs^Fp, Gs^Fp, Wo, Gs^Fp, Hh, Gs^Fp, Gg^Efm, Hh^Emf, Hhd^Dr, Mm, Re, Gs^Fp, Gg, Gg, Ds, Ds, Ds, Gs, Gs, Gg, Gs, Hh, Gs, Gll, Hh^Fp, Gs, Gs^Es, Gs^Es, Gs^Es, Gll^Es
Mm, Mm, Hhd^Emf, Hhd^Dr, Mm, Gd^Edt, Gd^Edt, Gs^Fms, Gd, Gd, Gg^Efm, Gg^Edt, Hh, Hh^Dr, Md, Md^Xm, Gd^Edt, Gg, Gs^Fp, Gs^Fp, Hh, Wo, Gs^Fp, Gs^Fp, Gg^Efm, Hh^Em, Gg^Efm, Gd, Gs, Rr, Rr, Ds, Wo, Ww, Ds, Wwr, Ds, Gg, Gg, Gd, Gd, Hh, Hh^Fp, Md, Hh^Fp, Md, Hhd, Gd
Hh, Hh^Fp, Gd, Gs^Edt, Gs^Edt, Gs^Edt, Gs^Fp, Gs^Fp, Gd^Fetd, Hh, Gg, Gs^Edt, Gs^Edt, Hh^Vhh, Hhd^Emf, Md, Hh, Gg, Gs, Hhd^Fp, Gll, Wo, Gs^Fp, Gs^Fp, Gg^Vh, Gg, Gg, Gg, Gg, Gd, Gs, Re, Re^Es, Ww, Ds, Wwr, Gg^Vh, Gd, Gg^Edb, Gg^Edb, Gll, Hh, Hhd^Fp, Hhd^Emf, Md, Hh, Gd, Md
Gs^Fp, Gs, Gs, Gg^Ve, Gg, Gd^Edt, Gs, Gd, Gs, Gs, Gg, Gd, Gd, Gs^Edt, Hh^Dr, Hh, Gd, Gs, Gg, Gs, Gd, Wo, Gll, Gg, Ww, Ww, Wwr, Gs, Gd, Gg, Gg^Efm, Gd, Re^Es, Ww, Ww^Wkf, Wwr, Gg, Gg, Gd^Edb, Gll^Efm, Gd^Edb, Hh, Hh, Hhd^Dr, Md^Xm, Gs, Gs, Gd
Gs^Fp, Gll, Md, Gs, Hh, Gg, Gs^Fp, Gg, Gg^Efm, Gs, Gs, Gg, Gd, Gs, Gd, Gd, Gs, Gg, Gg^Efm, Gs, Ds, Ww, Ww^Ewl, Ww, Wo, Wo, Wwr, Ds, Gs, Gs, Gg^Efm, Gd, Re, Re^Es, Ds, Ds, Gg, Gd, Gs^Edb, Co, Gd^Edb, Gg, Gg^Efm, Hhd, Gg^Efm, Mm, Gs, Gs^Fms
Mm, Hh, Md^Xm, Md, Hh^Emf, Md, Hh, Gg, Md, Md, Gs, Hh^Vhh, Hh, Gs, Mm, Gs, Gs, Gg, Gg, Gd, Ds, Ww^Wkf, Ww^Ewl, Wo, Wo, Wwr, Ds, Ds, Gg^Efm, Gg, Gs, Gs, Re, Gs, Gg^Edb, Gg, Gll^Gvs, Gs^Edb, Co, Co, Co, Gs^Edt, Gs, Gg^Efm, Gd, Mm, Gs, Gg^Efm
Ww, Mm, Mm, Hh, Md, Md^Xm, Md, Hh^Dr, Hh^Em, Hh, Hh, Gd^Fetd, Hh, Mm, Hh^Dr, Mm, Hh^Dr, Gs, Gll, Gs, Ds, Ww^Wkf, Ww, Wo, Ww^Wkf, Ww, Gd, Gg, Gs, Gd, Rr^Es, Re, Gg^Vh, Gs, Gs^Edb, Gll^Gvs, Gs, Gs, Co, 3 Ko, Gs^Edt, Gs^Edt, Gs^Ecf, Gd, Gs, Gd, Gs^Fms, Gs^Fms
Ww, Wo, Wwr, Hhd, Hhd, Md, Hhd^Dr, Hhd^Dr, Md, Hh, Gs, Gd, Hh, Hh^Em, Hh^Fp, Hh^Dr, Hh^Em, Hhd, Hhd, Gs, Gs, Gs, Gll, Ww, Ds, Ww, Ww, Gll, Re, Re^Es, Gg, Gg, Gs, Gg, Gs^Efm, Gs, Gd, Gs^Edb, Ds, Ds, Co, Gs, Gs, Gs, Gll^Gvs, Gll^Gvs, Gg^Efm, Gs^Fms
Gll, Ww, Gll, Gg, Gd, Hhd, Gs, Hh^Em, Md, Md, Gs, Md, Hh^Dr, Hh, Hh^Emf, Hh^Vhh, Hh, Mm, Hhd, Hhd, Md, Md, Gg, Gs, Gs, Ds, Ww^Bw/, Re, Gs, Gs, Gd, Gs, Gd^Edb, Gs^Edb, Md, Md, Md, Gd^Edb, Gd^Edb, Gs^Edb, Gs, Gs, Gs, Gll^Gvs, Gll^Gvs, Gll^Gvs, Gg, Gg
Wo, Ww^Bw\r, Gs^Fp, Gd, Gs^Fp, Gg, Gd, Md, Gd, Gd, Hhd, Md, Md, Md, Hh, Hh^Fp, Hh, Hhd, Mm, Hh, Md, Md^Xm, Re, Re, Re, Re, Ww, Gll, Gg^Efm, Gg, Gg^Ve, Gd, Gd, Hh, Hhd, Hhd^Fp, Hh^Emf, Hh^Fp, Gd, Gs, Gs^Fp, Gd, Gd, Gll^Gvs, Gs, Gs, Gs, Gll
Wo, Ww^Ewl, Wwr, Gd, Gg, Gg, Gg, Md, Gs, Hh, Hhd, Hh, Hhd^Fp, Hh, Hhd, Hh, Gd^Edb, Mm, Gll, Gs, Re, Re^Es, Gs, Gs, Gs, Gs^Dr, Ww, Gll, Gll, Gs, Gg, Gg^Efm, Gs, Md, Gs, Gs, Gs, Gs, Gg, Gg, Gg, Gg, Gs, Gd, Hh, Gs^Fp, Gs, Gd
Hh, Ww, Mm, Gll, Gg, Gg, Gd, Gs, Hh, Hh^Vhh, Md, Hhd, Gd, Gs, Gs, Gs^Edt, Gd^Edb, Gll, Gs, Gs, Gs, Gs^Edb, Gg, Gll, Gg, Gd, Ww, Ww, Ww^Wkf, Gs, Ds, Gg, Gs, Gs, Gg, Gg, Gg, Gg^Vo, Gg^Efm, Gll, Hh, Gs, Gs, Gs^Fp, Gll, Hhd, Gs^Fms, Gd
Hh^Fp, Hh, Hh, Hh^Fp, Hh^Fp, Hh, Gs, Hh, Mm, Mm, Mm, Gs, Md, Gs, Gs, Gg, Gg^Efm, Gs, Gg^Efm, Gg^Efm, Gg, Gg, Gg, Gg, Gg, Gs, Gs, Ds, Ww^Wkf, Ww^Ewl, Ww^Bw|, Ds, Ds, Gd, Gs, Gd, Gs, Gg^Efm, Gg, Gg, Gg, Gg, Gs, Gs^Fp, Hh, Hh^Fp, Hh, Gs^Fms
Hh, Hh^Vhh, Mm, Mm, Gs, Gd, Mm, Mm, Mm, Mm, Gd, Md^Xm, Md, Gs, Hh, Md, Mm, Gg^Efm, Gs^Fp, Mm, Gs, Gg, Gs, Gg, Gg^Ve, Gg, Gg, Ds, Ds, Ww, Rr, Ww, Ww, Ww, Ww^Ewl, Gd, Ds, Gs, Rr, Gd, Gg, Gg^Ve, Gg^Efm, Gs, Hhd, Hhd^Fp, Gs^Fp, Gs^Fms
Gs, Hh^Dr, Hh^Em, Gs, Hh, Hhd, Gs, Mm, Gs^Efm, Gd, Gg, Md, Gg, Gs, Gs, Gs^Fp, Gs, Hhd, Gs^Fp, Gs, Mm, Gs, Gs^Fp, Gs, Gg, Gg, Re, Gs, Re, Rr, Rr, Ds, Ww, Wo, Ww, Wwf, Wo, Ds, Rr, Gd^Es, Gd, Gg^Efm, Gg^Efm, Gs^Fp, Hh^Fp, Hhd, Gs, Gs
Hh, Gs, Gs, Gs, Gg, Gg, Gg, Gs, Gg, Gg, Gs^Edb, Gd, Gd, Gd, Gd^Edb, Gs, Gs, Gs^Fp, Gg, Gs, Gs^Fp, Gs^Vo, Gg, Gs, Gg, Gg^Efm, Gs, Re^Es, Gs^Edb, Gd^Edb, Gd^Edb, Re, Ww, Wo, Wo, Ww, Ww, Ww^Wkf, Rr, Gd, Gs, Gd, Gd, Gs^Fp, Gs, Hh, Gg, Gs^Fms
Hh, Gd, Gd, Gd, Gd, Gd, Gg, Gg^Vo, Gg, Hhd, Gd^Edb, Gd, Hh^Fp, Gs^Efm, Gs^Efm, Gd^Edb, Gs, Mm, Gg, Gs, Gs, Gs, Gg, Hh, Gg, Gg, Gs^Edb, Gs^Edb, Gg, Gg, Gg^Ve, Gs^Edb, Ww^Wkf, Ww^Ewl, Wo, Wo, Ww, Ww^Ewl, Ds, Gs, Ds, Gs, Ds, Gs, Ds^Ewsh, Ds, Ds, Gg
Gg, Gg, Gll, Gd^Efm, Gs, Gll^Gvs, Gll^Gvs, Gd, Gs, Gs^Edb, Hh^Fp, Co, Co, Gs^Fp, Gs^Edb, Gd^Edb, Gs, Gs, Gs, Gg, Gg, Gg, Gg, Gg^Efm, Gg, Gs, Gs^Edb, Gg, Gg, Gg, Gg, Gs, Gg, Ww^Wkf, Ww^Wkf, Ww, Ww, Ww^Ewl, Ds, Gg, Gg, Gs, Gs, Ds, Ds, Ww, Ds, Gs
Gg, Gll, Ww, Gll, Wo, Gs^Edb, Gd^Edb, Gd, Gs, Gs^Fms, Mm, 4 Ko, Co, Co, Gs^Edb, Gs, Gll^Gvs, Gll^Gvs, Gll^Gvs, Gs, Gg, Gg^Efm, Gd, Gg, Gd, Gs^Edb, Gd^Edb, Gg, Gg, Gg^Efm, Gg, Gg, Gg, Gg^Es, Gd, Ds, Ds^Ewsh, Ww^Wkf, Ds^Esd, Ds, Ds, Gg, Gll, Gs^Edt, Gd^Edt, Ds^Esd, Ds, Ds
Gd, Gd, Ds, Ww, Ww, Wo, Gll, Gll^Edb, Gs, Gs^Fp, Gd, Co, Ds, Gs^Edt, Gg, Gll^Gvs, Gll^Gvs, Gll^Gvs, Gs, Gg, Gg, Gg, Gs, Gd^Edb, Gs, Gd, Gs^Edt, Gs, Ds, Gg, Ds, Ds^Esd, Gs, Gs^Es, Gs, Ds, Ds^Ewsh, Ww, Ds, Ds, Gg, Gs^Fp, Gll, Gll, Ds, Ds, Gs, Gs
Gd, Ds, Ww, Ds, Wwr, Wo, Gll, Gg, Gg^Efm, Gs, Gd, Gd^Dr, Gd^Ecf, Ds, Gg, Gg, Gg, Gg, Gg, Gg, Gd, Gs, Gs^Fp, Gs, Gs, Gs^Edt, Ds, Gs^Edt, Ds, Ds, Gd, Ds, Gs, Gs^Fp, Gs^Fms, Gs^Fms, Ds, Ds, Ds, Ds, Gs, Gg, Ds, Gd^Edb, Gd, Ds, Gs^Fp, Ds
Gd, Gs^Edt, Ds, Ww^Wkf, Ww^Wkf, Ww^Wkf, Gg, Gg^Vo, Gg^Efm, Gs, Ds, Gs, Gs, Gs, Gs, Gd, Gd, Gg^Efm, Gs, Gd, Ds^Esd, Ds^Esd, Ds^Esd, Hh^Fp, Ds, Ds, Gs, Ds, Gd^Edb, Ds, Gs, Ds, Ds, Ds, Ds, Gg^Efm, Ww, Ds^Ewsh, Gs^Fms, Ds^Ewsh, Gd, Ds^Ewsh, Gs, Ds, Gs^Edt, Gs, Gs^Fp, Ds
Gs, Gs, Gs^Fp, Gs^Fp, Gd, Gll, Gs, Gg, Hh, Gs, Gs, Gs, Gll^Gvs, Gll^Gvs, Gll^Gvs, Gd, Gg, Gg, Gs^Edt, Ds, Ds, Ds, Ds, Hh^Fp, Ds, Gd, Ds, Gs, Gs, Gs^Fp, Gs^Fms, Gs^Fp, Md, Hh^Fp, Gs^Fp, Ds, Gs^Fp, Gg^Efm, Hh, Hh, Gs, Gg, Ds, Ds, Ds, Ds, Gs, Gs
Gg, Gs, Gs, Gs, Wo, Gs, Gll, Gg, Gg, Gg, Gd^Efm, Gd, Gd, Gll^Gvs, Gd, Gd, Gd, Ds, Gs, Ds^Ewsh, Ds, Ds, Ds, Ds^Esd, Ds, Ds, Gd^Efm, Gs^Fp, Gs^Fms, Gg^Fet, Hh^Fp, Gg, Hhd, Gs^Fp, Gg^Efm, Gg, Ww, Gs^Fp, Md, Hhd^Fp, Hh^Fp, Gs^Fp, Ds, Wwr, Ww, Ds, Ds, Ds^Ewsh
Gg, Gll, Ww^Wkf, Ww, Wwr, Wo, Gll^Edt, Gg, Gs^Edt, Gs, Gs, Ds, Gs, Gs, Ds, Ds^Ewsh, Ds, Gg, Gs, Ds^Ewsh, Ds, Wwf, Ww, Ds, Ds, Gs, Gg^Efm, Ds, Ds, Gs^Fms, Hh, Hhd^Fp, Gd, Ds^Ewsh, Ds, Ww, Ds, Ww^Wkf, Gll, Gll, Gg, Gs, Gd, Ds, Ds, Ds, Ww, Ds
