Hh, Hh, Hh, Hh, Mm, Mm, Mm, Mm, Mm, Gg, Gs^Fp, Gd, Hh, Gg, Mm^Xm, Gg, Gs, Gs^Fdw, Gs, Wwf, Wwr, Hh, Mm, Hh, Hh, Hh, Mm^Xm, Hh, Hh, Gg, Gs, Gg, Gg, Gg, Hh, Mm, Mm, Hh, Hh, Gg^Efm, Gg, Gg, Gg, Gg, Gg, Gg, Gs^Fp, Gd, Ww^Wkf, Wwr, Gs, Gs, Gg, Gg, Gg, Hh, Mm, Mm, Hh, Hh
Mm, Mm, Mm, Mm, Mm, Mm, Mm, Mm, Hh, Hh, Gs, Gd, Hh, Mm, Mm, Mm, Gs, Ds, Wwf, Wwf, Wwr, Mm, Mm, Mm, Mm, Mm, Mm, Mm, Hh^Fdw, Gs, Hh^Fdw, Gs^Efm, Gg, Hh, Hh, Hh, Gs, Mm, Gs, Gs, Hh^Fdw, Gg, Mm, Mm, Mm, Hh^Fp, Hh^Fp, Gd, Ww^Wkf, Wwr, Wwr, Gs^Efm, Gg, Gg, Mm, Mm, Mm, Mm, Mm, Hh
Mm, Mm, Mm, Mm, Mm, Mm, Hh^Vhhr, Hh^Fp, Gs^Fet, Hh^Fdw, Hh^Fp, Gs^Fdw, Hh, Hh^Fdw, Hh^Fdw, Hh^Fdw, Gd, Ds, Wwf, Wwr, Mm, Mm, Mm, Mm, Mm, Mm, Mm, Mm, Mm, Mm, Hh^Em, Hh, Hh^Fmw, Hh^Fmw, Gd, Gd^Fdw, Gd^Fdw, Gs, Gg, Gg, Gs, Mm, Mm, Mm, Mm, Mm, Mm, Gd, Gd^Fmw, Ww^Wkf, Wwr, Gs, Gd^Efm, Gd^Fdw, Hh^Fdw, Mm, Mm, Mm, Mm, Hh
Hh^Em, Mm, Mm, Mm, Hh^Fmw, Gs, Gg, Gs^Fp, Gs^Fp, Hh^Fp, Mm, Mm, Mm, Hh, Hh, Gg, Ds, Ds, Ww, Ww^Wkf, Hh, Mm, Mm, Mm, Mm, Mm, Hh^Dr, Mm, Mm, Hh^Em, Hh^Emf, Hh^Em, Hh, Gd^Fmw, Mm, Mm, Mm, Hh, Hh^Fdw, Gs^Fdw, Mm, Hh, Hh, Mm, Mm, Mm, Gd, Gs^Fp, Gd^Fmw, Ww^Wkf, Wwf, Wwr, Wwf, Gs, Mm, Mm^Xm, Mm, Mm, Hh, Hh
Hh^Emf, Hh^Em, Hh, Hh, Gg, Gg, Co, Co, Co, Hh^Fp, Mm, Mm, Mm, Mm, Mm, Gg, Ds, Ww, Wwr, Wwr, Wwr, Hh^Em, Hh^Emf, Mm, Mm, Mm, Mm, Mm, Mm, Mm, Mm, Hh^Fdw, Hh, Hh, Mm, Mm, Mm, Mm, Mm, Hh^Fp, Hh^Vhh, Mm, Mm, Hh, Gg, Gg, Gs^Fp, Gg^Fet, Gs^Fmw, Gd, Gs^Fdw, Wwf, Wwf, Gs, Gg, Mm, Mm^Xm, Hh^Fmw, Hh^Fmw, Hh
Hh, Hh^Em, Gs, Gd, Gs, Gg, Co, 4 Ko, Co, Gs^Fmw, Hh^Fdw, Mm, Mm, Mm, Hh, Gg, Ww^Wkf, Ww, Ww^Wkf, Hh, Mm, Hh^Em, Hh^Em, Hh^Em, Hh, Mm, Mm, Mm, Mm, Mm, Mm, Mm, Mm, Mm, Mm, Mm, Hh, Mm, Gs^Fdw, Hh^Fp, Hh^Fp, Hh^Fdw, Gg, Gg^Efm, Gd^Efm, Gd, Wwr, Gs^Fp, Wwr, Gs, Ww^Bw\r, Wwf, Wwf, Wwr, Gg, Mm, Mm, Mm, Gs^Fmw, Gs
Gs, Gs, Gd^Vo, Gd^Efm, Gs, Gg, Gg, Co, Gg, Gs^Fdw, Gg, Hh, Hh, Hh, Gg^Efm, Gs, Ww^Wkf, Ww^Wkf, Hh^Fmw, Mm, Mm, Mm, Mm, Mm, Mm, Hh, Hh, Mm, Mm, Mm, Mm, Mm, Mm, Mm, Hh^Em, Hh^Fmw, Hh^Fmw, Gs^Fdw, Co, Co, Co, Gg, Gs^Fp, Gg, Gd^Efm, Ds, Ww^Wkf, Wwr, Ww, Wwr, Wwr, Wwf, Ww^Bw\r, Wwr, Gg, Gs, Gs, Gd, Gd^Efm, Gd
Gg, Gs, Gg^Efm, Gs^Efm, Hh, Gs^Fmw, Gs^Fmw, Gg, Gd^Vo, Gs, Gs^Fmw, Gg, Gg, Gg^Efm, Gs^Fmw, Gs^Fmw, Ww^Wkf, Wwr, Hh, Hh^Fmw, Hh, Mm, Mm, Mm, Hh^Fmw, Mm, Gg, Gg, Gg, Mm, Mm, Mm, Mm, Hh^Em, Hh^Emf, Hh^Em, Gs^Fdw, Gd, Co, 2 Ko, Co, Gg, Wwf, Gd, Ds, Ds, Wwr, Ww^Wkf, Wwr, Ww, Ww^Wkf, Wwf, Wwr, Gg, Hh, Hh, Mm, Gs, Hh, Hh
Gg^Efm, Gg, Gs, Gs, Hh, Hh, Hh^Fmw, Gs, Gd, Gs, Gs, Gg, Gg, Gs, Wwr, Wwf, Wwr, Wwr, Wwr, Hh, Ds, Ds, Ds, Gs^Fmw, Hh, Gs, Hh, Gs, Gs, Hh^Fdw, Mm, Mm, Hh, Hh^Em, Hh^Em, Hh^Em, Gs^Fmw, Gs^Fp, Gg, Co, Gg, Gg, Wwf, Ds, Wwr, Wwr, Ww, Ww^Wkf, Wwr, Ww^Bw\r, Ww^Wkf, Wwr, Gg, Gg^Efm, Mm, Mm^Xm, Mm, Mm, Mm, Hh
Gg, Gg, Gs^Fmw, Hh, Hh, Hh, Mm, Mm, Mm, Gs, Gs, Ds, Wwr, Wwr, Wwr, Ww^Bw\r, Wwf, Wwf, Wwf, Ds, Wwf, Wwf, Ds, Gs, Mm, Mm^Xm, Mm, Gs^Fdw, Hh^Fmw, Mm, Mm, Mm, Mm, Gg^Efm, Gg, Gs^Fmw, Gg, Gg, Gs, Gg, Gd^Vo, Gg, Wwr, Ww, Ww^Wkf, Ww, Gg, Ds, Ds, Wwr, Ds, Ds, Gs, Gs, Gd^Fdw, Mm, Gs, Hh^Fdw, Hh^Fdw, Hh
Gs^Fdw, Gs^Fdw, Gs^Fmw, Hh, Mm, Mm, Mm, Mm, Hh^Fmw, Gd, Ds, Ds, Wwr, Wwf, Ds, Wwr, Wwr, Wwr, Ds, Ds, Wwf, Ds, Gg, Gs, Gs, Mm, Hh, Hh^Fmw, Hh, Hh^Fp, Hh, Mm, Hh, Gs, Gs^Efm, Gg, Gd^Vo, Gs, Gs, Gg, Gs, Gs, Ww, Ww, Gg, Gg, Gs^Fdw, Gg, Gs, Ds, Gs, Ds, Gs, Gd, Gs, Gs^Fdw, Mm^Xm, Gs, Gs^Fdw, Hh
Hh^Fmw, Gs^Fet, Hh, Hh^Fmw, Hh^Em, Mm, Hh, Hh^Fmw, Gs^Fmw, Gd, Ds, Wwr, Wwf, Wwf, Ww^Wkf, Ds, Wwr, Wwr, Wwf, Wwf, Wwr, Ds, Gs, Gg, Gs^Efm, Hh^Fdw, Gs^Fdw, Hh^Fp, Gs, Hh, Gs, Hh, Gs, Gs, Gg, Gs, Gd, Gd^Efm, Hh, Hh^Fdw, Wwr, Ww, Ww, Ww^Bw\r, Gs, Gs, Gs^Fdw, Gs^Efm, Gd^Vo, Gs, Gd^Fmw, Gs^Fmw, Gs, Gd, Gs, Mm, Mm, Mm, Gs^Fdw, Gg^Fdw
Hh, Hh^Fmw, Hh^Fp, Hh^Em, Hh^Emf, Hh^Em, Hh^Fp, Gs^Fet, Gs^Fp, Gs^Fp, Gs^Fp, Wwr, Wwr, Ww^Bw\r, Ww^Wkf, Ds, Wwf, Wwr, Wwr, Wwr, Gg, Gg, Gd^Vo, Gs, Gs^Fdw, Gd, Co, Gs, Gs^Fdw, Gs, Gd, Gs^Fdw, Gg, Gg, Gd^Wm, Gs, Gd, Hh, Gd, Gs^Fdw, Wwr, Ww^Wkf, Ds, Gg, Gs^Efm, Gs^Fdw, Mm, Gd, Gd, Gs, Gg^Fet, Gs^Fmw, Gs, Gd^Ecf, Gs, Hh^Em, Hh^Emf, Hh^Em, Gs, Gg
Mm, Mm^Xm, Mm, Hh^Fdw, Mm, Hh^Em, Hh, Hh^Fp, Hh, Hh, Gs^Fp, Gg, Gg, Wwr, Ww^Bw\r, Ww^Wkf, Wwf, Wwr, Ds, Gs, Gg, Gs, Gs, Gs, Gs^Efm, Co, 3 Ko, Co, Gs^Fdw, Gd^Vo, Gd, Hh, Hh, Gg, Gs, Gs, Gd, Gd, Gs, Gs^Fdw, Wwr, Ww^Wkf, Ww^Wkf, Ds, Gs, Mm, Mm, Mm, Mm, Gd, Hh^Fmw, Gd^Fmw, Gs, Gg, Gs, Gs, Ce, Gs, Gs, Gg^Efm
Hh, Mm, Hh^Emf, Mm, Mm, Mm, Mm, Hh^Fmw, Hh^Fmw, Mm, Mm, Gs^Fdw, Gs^Efm, Gg, Ww, Ww, Ds, Ds, Gs, Gs, Gd, Gs, Mm, Gs, Gs, Co, Co, Co, Gs, Gs, Hh, Hh, Mm^Xm, Gg, Gs, Gs, Gd^Vo, Gg^Efm, Wwr, Wwr, Wwf, Wwr, Ds, Ds, Gg, Mm, Mm, Mm, Mm, Mm, Mm^Xm, Gd, Gg, Gg^Efm, Gs, Ce, 1 Ke, Ce, Gd^Fmw, Gg
Hh, Hh^Em, Hh^Em, Hh^Em, Mm, Mm, Mm, Mm, Mm, Mm, Mm, Mm, Gs^Fdw, Ds, Ww, Wwf, Ds, Gg, Gd, Gd^Efm, Mm, Mm, Mm, Mm, Mm, Gs, Gs, Gs^Fdw, Gs, Hh^Fdw, Mm, Mm, Mm, Mm, Hh, Gs, Gd, Gg, Ww, Wwf, Ds, Ds, Gd^Fdw, Gd^Fdw, Gg, Hh, Mm, Mm, Hh^Vhhr, Mm, Mm, Mm, Hh^Fdw, Gg, Gs, Ce, Ce, Ce, Gd^Fmw, Gg
Hh, Hh^Fdw, Mm, Mm, Mm, Mm, Mm, Mm, Mm, Mm, Hh, Gg, Gs, Ds, Wwr, Wwf, Ds, Hh, Hh^Fdw, Mm, Mm, Mm, Mm, Mm, Hh^Vhh, Gs^Fmw, Gg, Gg^Efm, Gs, Mm, Mm, Mm, Mm, Hh, Hh^Fdw, Gs^Fdw, Gg, Gg, Wwr, Wwf, Gd, Gs, Gs^Fdw, Gg, Mm, Mm, Mm, Mm, Mm^Xm, Mm, Mm, Hh, Hh^Fdw, Gg, Gg, Gs, Gs, Gs^Fdw, Gs^Fdw, Gg
Hh, Mm, Mm, Mm, Hh, Hh, Hh, Mm, Hh, Hh^Fmw, Hh, Gg^Efm, Gs, Ds, Wwr, Wwf, Ds, Hh, Hh, Hh, Hh, Hh, Hh, Hh^Fdw, Hh, Gg, Gg, Gg, Gg, Hh^Fmw, Hh, Mm, Mm, Mm, Hh, Gs, Wwr, Wwr, Wwr, Wwf, Gd, Gs^Efm, Gs, Mm, Mm, Mm, Hh, Mm, Mm, Mm, Hh, Mm, Hh, Hh^Fdw, Gg, Gg, Gg, Gs^Fdw, Gg, Gg
