Gd, Gg, Gg, Gg, Gg^Efm, Gg, Gd, Gd, Gd, Gg, Gs, Gs, Gs, Gg, Aa, Gg, Gg, Gg, Aa, Gg, Gs, Gs, Gs, Gs, Gs, Gg, Re^Es, Gs, Gg, Re, Gs, Gs, Gs, Re, Gs, Gg, Gg^Efm, Gg, Ds, Ds, Ww, Ww, Ww, Ds, Gg, Gs, Gs^Fp, Gs^Fp
Gg, Gd^Edt, Gs, Gg^Efm, Gg, Gg, Gg, Gll, Gg, Gd, Gll, Gll, Hh, Hh, Hh, Hhd, Hhd, Gs^Esa, Aa^Esa, Gs^Edt, Gs^Edt, Gll, Gg^Edt, Gg, Gd, Aa, Re^Es, Gs, Gs, Gg, Gg^Efm, Gd, Re, Re^Es, Gs, Gg, Gg, Gg, Ds, Wwf, Wwr, Wwr, Wwr, Ds, Ds, Gs, Gs, Gs^Fp
Gs, Gd, Gs^Es, Gg, Aa, Gg, Gs^Edt, Aa^Vha, Gs, Gd, Aa^Esa, Md, Aa^Vha, Md, Md, Aa, Mm, Mm, Aa^Vha, Gs^Edt, Md, Gs^Edt, Gd, Gg, Gd, Aa, Gg, Re, Re, Gs^Edt, Gg^Efm, Gd, Re, Gs, Gg^Efm, Gll^Em, Gs, Gg, Gg^Esa, Ds, Ds, Ww^Ewl, Ww^Ewf, Ww, Ww, Gg^Efm, Ds, Gs
Ds, Gll, Ds, Gd, Gd^Edt, Gd^Edt, Ds, Gs^Edt, Aa, Gd, Gd^Edt, Md, Aa^Es, Aa^Es, Cha, Rr, Cha, Aa^Esa, Mm, Aa, Gd, Gd, Gd, Gg, Gg, Gd, Gg, Gs^Ve, Re, Gs, Gd, Re, Gd, Gs, Gg^Efm, Gs, Gs^Fp, Gs, Gd, Gg^Esa, Gg, Ds, Ds, Wo, Ww^Bw|, Ww^Wkf, Ww, Gs^Fp
Ww, Ww, Ww, Ds, Ww, Ds, Ww^Ewl, Ds, Ds, Gg^Efm, Gs^Edt, Md, Aa, Ha, Cha, 2 Kha, Cha^Edt, Mm, Aa^Es, Gs^Es, Gd, Aa, Gd^Edt, Aa, Gll, Gg, Aa^Esa, Gs, Gs^Esa, Re, Re^Es, Re, Gs, Gg, Gs^Fp, Gs^Fp, Aa, Gs^Fp, Gd, Gd, Gd, Gg^Efm, Gg^Efm, Ds, Gs, Ds, Wwf, Ww
Ww^Wkf, Ww^Ewl, Ww, Ww, Ww, Ww^Ewl, Ww^Wkf, Ww^Wkf, Ww^Ewl, Aa, Ds, Gs^Edt, Gd^Edt, Mm, Ha, Cha, Aa^Vha, Ha, Hhd^Em, Gd, Aa^Esa, Aa, Gd^Esa, Gll, Gs^Edt, Gg, Aa, Gs^Esa, Re^Es, Re^Es, Gs, Gs, Gg, Gg^Esa, Gg^Esa, Gs^Fp, Aa^Esa, Gs, Gll, Gs^Fp, Gll, Gd^Edt, Gg, Gg^Efm, Gs, Ds, Ds, Ww
Gg, Gs^Fp, Ww^Bw\, Wo, Wo, Ww^Wkf, Wo, Ww^Wkf, Wo, Ww, Wwr, Gg, Gll, Aa^Vha, Hh, Mm, Hhd^Em, Aa^Esa, Aa^Esa, Gs, Gd^Es, Aa^Esa, Gd^Esa, Gll^Edt, Gs, Gs^Edt, Gg, Gs, Re, Gd, Gg, Gg, Gg^Esa, Gg, Gs, Aa, Gs, Gd, Gd, Gll, Gd, Gd^Edt, Gg, Gg, Gs^Fp, Gs, Ds, Ww
Ww^Wkf, Gd^Ve, Ww, Ww, Wo, Wo, Wo, Wo, Wo, Wo, Wo, Wwr, Gll, Aa, Aa^Vha, Hh, Aa, Hhd^Em, Md, Gs, Gd^Es, Aa, Gd, Gs^Edt, Gs, Gll, Gs, Gs^Vh, Re, Gs, Gll^Em, Gll^Em, Gg, Gg, Gs, Gs, Gs, Gg^Efm, Gg, Gd, Gg, Gd, Gg, Gg, Gs^Fp, Gs, Gs^Fp, Ww^Wkf
Ds, Ww^Wkf, Ww, Wo, Wo, Ww^Ewl, Ww^Bw\, Ww, Ww, Ww, Ww^Bw\, Wwr, Gs, Gs, Gs, Gd, Gd, Gd, Aa, Gs, Gd^Es, Aa, Gd, Gs, Gg, Gg, Gg, Re^Es, Re, Gs, Gg, Gg, Gg, Gs^Fp, Gll, Gs^Fp, Gd, Gs, Gd, Gs, Gg, Gg, Gg, Aa, Aa^Esa, Gs^Fp, Gg, Ds
Gg, Ds, Gd, Ww^Ewl, Ww^Wkf, Ww, Gll, Gll, Ww^Bw\, Wwr, Gll, Gg^Ve, Gg, Aa, Gg, Gd, Gg, Gg, Aa, Gs, Aa, Gd, Aa, Gg, Gg, Gs, Gg^Efm, Gs, Re^Es, Gd, Gd^Esa, Gg, Md, Gg, Gg, Gs^Fp, Gs^Fp, Gs^Fp, Gd, Gs, Gg, Gs^Edt, Gs, Gs^Esa, Gg, Aa^Esa, Gg, Gg
Gd, Gs, Gs, Gd^Es, Gd, Ds, Gs, Ww, Gs, Gll, Gg, Gs, Gg, Gg, Gs^Fp, Gg, Gg, Gg^Esa, Gg^Esa, Aa^Esa, Gs, Gs, Gg, Gg, Gs^Vh, Gll, Gg, Gs, Gs^Es, Re, Gd^Esa, Gg, Hh, Md, Md, Gg, Aa^Esa, Gs^Fp, Gs, Aa^Esa, Aa^Esa, Gs, Gs, Gd, Gd^Edt, Gg, Gg^Efm, Ds
Gs^Fp, Gd, Aa^Esa, Gs^Esa, Gs^Esa, Gs, Gg^Efm, Gs, Gs, Gg, Gs^Fp, Gd, Gg^Es, Gg, Gg^Vh, Gs^Fp, Gg, Aa^Esa, Gg, Gs^Edt, Gd^Edt, Gs^Es, Gs, Gll, Gg, Gll, Gg, Gg, Gg, Re^Es, Gd, Gg, Gg, Hh^Dr, Gd, Hhd^Em, Gg, Gs^Esa, Gll^Em, Gs, Aa, Gs^Esa, Gs, Gs^Edt, Gs, Gg, Ds, Ds
Gd, Gd, Gs, Gs^Esa, Gs^Fp, Gs^Esa, Gs^Efm, Hh^Fp, Gg, Gd, Gll, Gd, Gll, Gs^Es, Gs, Gs, Gs, Aa, Gg, Gs^Edt, Gll, Gg, Gg, Gg, Aa, Aa, Gg, Hh, Gg, Re, Re, Gs, Gd, Gd, Md, Gd, Gs, Gs, Gs^Fp, Gg, Gs^Fp, Gg, Gg^Esa, Gg^Efm, Gs, Gs, Ww^Wkf, Ww
Gg, Gs, Gs^Es, Gs^Es, Gll, Hh^Fp, Gs, Gg, Gg, Gg, Gg, Gll, Gg, Gg, Gg^Efm, Gs^Fp, Gg^Efm, Gs, Gs, Gg, Gd, Gd, Gd^Edt, Gg, Aa^Esa, Gs^Esa, Gs, Hhd^Em, Hh^Emf, Gg, Re, Gs, Gs, Gs^Esa, Gs, Gs, Gs, Gs^Fp, Gs^Fp, Gs, Gs, Gg, Gs, Gs, Gll, Wwf, Ww^Wkf, Ww
Gd, Gs, Gg, Gg, Aa, Gs, Gg, Gg^Efm, Gd, Hh^Fp, Gg, Gs, Gs, Gs, Gs, Gg^Efm, Hhd, Hh, Hhd^Em, Hh, Hh, Mm, Hh^Em, Gg, Gg^Em, Gs, Mm, Mm, Hh^Fp, Gs, Gd, Re, Gs^Esa, Aa^Esa, Gg, Gg, Gg, Gs^Fp, Gs, Gs^Fp, Gs, Gs, Gd^Edt, Gll, Ww, Ww, Ds, Ds
Gd, Gg, Gg^Efm, Aa, Gg, Gg, Gg^Efm, Gg, Gll, Gs^Fp, Gd, Gg, Aa^Esa, Gs^Fp, Gs, Gg, Gg^Vh, Gs^Fp, Gs^Fp, Hhd^Fp, Hh^Fp, Md, Hh, Gg, Gs, Gs^Em, Gs^Em, Mm, Hh^Fp, Hhd, Gs, Re, Gd, Gg, Gs, Gs^Fp, Gs, Gg, Gd, Gs, Gs, Gd, Wwr, Wwr, Ds, Ww, Ww, Ds
Gs^Fp, Gd, Gg^Ve, Gg, Gs^Fp, Gg, Gs, Gs^Es, Gll^Es, Gll, Gd, Gg, Gg^Esa, Aa^Esa, Gg, Gg, Gs^Fp, Gs^Fp, Gs, Gs, Mm, Md, Gg, Gg, Gs, Aa, Gs^Em, Mm, Hh^Em, Gs, Re^Es, Re, Gs^Fp, Gd, Gs, Gs, Gg, Gg, Gg, Gll^Em, Gs, Gs^Edt, Wwr, Ds, Gg, Ds, Ww, Wo
Gd, Gs^Fp, Gs^Fp, Gs^Fp, Gd, Gs, Hh^Fp, Gs, Gs^Fp, Gs, Gs, Gg, Gll, Gg, Hh^Fp, Gg^Efm, Gg^Efm, Gs, Gg, Gg, Gg^Esa, Gs^Fp, Gg, Gg, Gs^Es, Gs, Gd^Esa, Hh, Gs^Efm, Gs, Re, Re, Gg, Gd, Gg^Efm, Gs, Gg, Gs^Fp, Gg, Gd^Edt, Gs, Ds, Ww, Ds, Gs, Ds, Ds, Ww^Wkf
Gs^Fp, Gs^Fp, Gs^Fp, Gs^Fp, Gs^Fp, Gs, Hh^Fp, Gs^Fp, Gs^Fp, Gs^Fp, Gs^Fp, Gs, Gs, Gg, Gs, Gg, Gg^Efm, Gg, Aa, Gs, Gg, Gg, Gs^Vh, Gg^Es, Gs^Es, Aa^Esa, Gd, Gs^Esa, Re^Es, Re^Es, Gs, Gg, Gll, Gs, Gll, Gll^Efm, Gg, Gg, Gll, Gs, Ds, Ds, Ww, Gd, Gs, Gs^Edt, Ds, Ww
Gs^Fp, Gs^Fp, Gs^Fp, Gs^Fp, Gs^Fp, Gs^Fp, Gs^Fp, Gs^Fp, Gg^Ve, Gs^Fp, Gs^Fp, Gs^Fp, Gd, Gs^Edt, Gs, Gg, Gg, Gd, Gd, Gs, Gll, Gg, Aa^Esa, Gs, Gg, Gd, Gg, Gg, Re, Gs^Ve, Gs, Gg, Gs, Gll, Gs, Gg, Ds, Gs, Wwr, Wwr, Wwr, Ww, Ds, Gd^Edt, Gll^Edt, Gs, Gs, Ds
Gs^Fp, Gs, Gs^Fp, Hh^Fp, Hhd^Fp, Hhd^Fp, Hh^Fp, Gs^Fp, Gs^Fp, Gs^Fp, Gs^Fp, Gs^Fp, Gd^Es, Gs^Es, Gg^Es, Gg, Hh^Fp, Gs, Gd^Em, Aa, Aa, Gg, Aa, Gs^Esa, Gg, Gg^Esa, Gg, Gs^Efm, Re, Re^Es, Ww, Ds, Ds, Gs, Ds, Ds, Ww, Ww, Gs, Ds, Gs, Ds, Gs, Gs^Esa, Gll, Gg, Gg, Gd^Edt
Gg, Gs, Gs^Fp, Gs^Fp, Gs^Fp, Gg^Ve, Gg, Gs^Fp, Gs^Fp, Gs^Fp, Hh^Fp, Gs^Fp, Gs^Fp, Gs, Gg, Gg, Gs^Fp, Gg, Gd^Em, Gd^Emf, Gs^Em, Gg, Gg, Gg, Gd, Gs, Ds, Re, Wo^Bw\, Ww^Bw|, Ds, Ww, Ds, Ds, Ds, Ds, Ww, Ds, Gs, Gs, Gg^Edt, Gs, Gg, Gg, Md, Md, Md, Gg^Efm
Gs^Fp, Gs^Fp, Gs^Fp, Gs^Fp, Gs^Fp, Gs^Fp, Gs^Fp, Gs^Fp, Hhd^Fp, Hh^Fp, Gs^Fp, Gs^Fp, Gs, Gll, Gll, Gg, Gg, Gd, Gs, Gs^Em, Aa, Gs, Gg, Gs^Wm, Gd, Ds, Wwr, Wo, Gs^Ve, Rr, Gs, Ww, Ww^Wkf, Ww^Wkf, Ww, Ds, Ww, Ds, Gd, Gg^Edt, Gll, Hh, Gg, Gg^Efm, Hhd, Hhd^Dr, Hh, Mm
Gs^Fp, Gs^Fp, Hhd^Fp, Gs^Fp, Gs^Fp, Gs^Fp, Gs^Fp, Gs^Fp, Gs^Fp, Hh^Fp, Gs^Fp, Gs^Fp, Gs^Fp, Gll^Fp, Gg, Gg, Gg^Efm, Gd, Gs, Gs^Esa, Gd^Esa, Gd, Gs, Gd, Wwf, Wwf, Ww, Ww, Rr, Rr, Gs, Gll, Gd, Ds, Ds, Wwr, Wwr, Ds, Gd^Edt, Gg, Hh^Fp, Hhd, Gg, Gg^Efm, Gs, Gll, Gs^Efm, Gd
Hh^Fp, Hh^Fp, Hhd^Fp, Hhd^Fp, Gs^Fp, Gs^Fp, Gs^Fp, Gs^Fp, Gs^Fp, Gs^Fp, Gs^Fp, Gs^Fp, Gs^Em, Gll^Emf, Gg, Gg^Ve, Gg^Efm, Gg, Gg, Gg, Gs, Gs, Ww, Ww^Wkf, Ww^Wkf, Ww^Wkf, Gll, Gll, Re, Gs, Gd, Gs^Esa, Gs, Gd^Edt, Gs^Edt, Ds, Wwr, Ds, Gs, Gs, Gd, Gg, Gs^Fp, Gg^Efm, Gs, Gll, Gll, Gs
Hh^Fp, Hh^Fp, Gs^Fp, Gs^Fp, Gs^Fp, Gs^Fp, Gs^Fp, Gs^Fp, Gs^Fp, Gs^Fp, Gs^Fp, Gll^Fp, Gs^Fp, Gs^Em, Gs^Em, Gg^Efm, Gg, Gg, Gs^Fp, Gg^Vh, Gs, Ds, Wo, Ds, Gs, Gll, Gs, Gs, Re, Gd^Esa, Gd, Gll, Gg, Gs, Gs^Edt, Ds, Gd, Ww, Ww, Ds, Gs^Fp, Gs^Fp, Gs^Fp, Gs^Fp, Gg, Gs, Gs, Gs^Fp
Gg, Hh^Fp, Gs^Fp, Gs^Fp, Gs^Fp, Gs^Fp, Gs^Fp, Gll, Gll, Gg^Ve, Gll^Em, Gll^Fp, Gs^Fp, Gs^Esa, Gd, Gd, Gd, Gs, Gs, Gs, Ds, Wo, Ds, Ds, Gs, Gs, Gd^Em, Gs^Em, Re, Gs, Gll^Edt, Gd, Gg^Efm, Gg, Gg, Gs, Gll, Gd^Edt, Ds, Ww^Wkf, Ww, Ds, Ds, Gs, Gs, Gg, Gs^Fp, Gs
Gs^Fp, Gs^Fp, Gs^Fp, Gs^Fp, Gs^Fp, Gg^Efm, Gg^Efm, Gg^Efm, Gd, Gll^Em, Gs^Emf, Gs^Em, Gs^Fp, Gs, Gd^Esa, Gs^Fp, Gg, Gg, Ww, Ds, Ww, Wo, Gs, Gd, Gs^Fp, Gd, Gg, Gs^Emf, Rr, Gd, Gll, Gg, Gg^Efm, Gg^Efm, Gg, Gs, Gll, Gd^Edt, Gd, Ds, Ds, Ww, Ww, Ds, Gd, Gs, Gs^Edt, Gg
Gs^Fp, Gs^Fp, Gs^Fp, Gs^Fp, Gd, Gs^Fp, Gs^Fp, Gs^Fp, Gd, Gd^Em, Gs^Em, Gs, Gs, Gs, Gg, Gg, Gg, Ww, Wwf, Ww, Ww, Ds, Gd, Gs^Fp, Gs^Em, Gs^Em, Gg, Gg, Re, Gs, Gd^Edt, Gll, Gg, Gg, Gg, Gs, Gs, Gs, Gs, Gs, Ds, Wo, Ww, Ds, Md, Gs, Gd, Gs
Gs^Fp, Gs^Fp, Gg^Ve, Gg, Cv, Gll^Edt, Gll^Edt, Gs^Fp, Gs^Fp, Gs^Fp, Gs, Gs^Fp, Gg, Gs^Fp, Gg, Gg, Gs^Fp, Ww, Ds, Wwf, Ds, Gd, Gs^Fp, Hh^Fp, Gs^Em, Gs^Emf, Gg, Gs^Em, Gs, Re, Gd^Edt, Gll, Gg, Gg, Gg^Edt, Gg^Efm, Gg^Efm, Gs, Gg, Gg, Gg, Ds, Md, Ww^Wkf, Hhd^Vhh, Md, Gd, Gg^Efm
Gs^Fp, Gs^Fp, Gs^Fp, Cv^Edt, Cv, Cv^Edt, Gd^Edt, Gll^Fp, Gs^Fp, Gs, Gs^Fp, Gs, Gs, Gs^Fp, Gs, Gg^Ve, Gs^Fp, Ww, Wwr, Ds, Gs, Gs, Gs^Fp, Gs^Fp, Gs, Gg^Efm, Gg, Gll, Gs, Re, Re, Gd^Edt, Gs, Gs^Edt, Gs, Gg, Gd, Gg, Gg^Efm, Gg, Gs, Gs, Md, Ww^Wkf, Hh^Em, Md, Gs^Fp, Gd
Gll, Gll, Cv, 3 Kv, Gs^Fp, Gs^Fp, Gs^Fp, Gll^Fp, Gs^Em, Gs, Gg, Gs^Fp, Gs^Fp, Gg, Gs, Gs^Fp, Gs^Fp, Ww^Wkf, Wwr, Ds, Gd^Fp, Gs, Gg, Gs, Gg^Efm, Gg^Efm, Gg, Gg^Efm, Gg, Gg^Ve, Re^Es, Gs, Hh^Fp, Gs^Fp, Gs^Fp, Gd, Re^Es, Gd, Gg^Efm, Aa, Aa^Esa, Gs^Esa, Gs^Fp, Md, Md, Md, Md, Gs^Fp
Gg, Gll^Efm, Gg^Ve, Gs^Fp, Gs^Fp, Gs^Fp, Hh^Fp, Hhd^Fp, Gs^Emf, Gg^Efm, Gs^Fp, Gs^Fp, Gs^Fp, Gd, Gg, Gs^Esa, Gs^Esa, Gs^Fp, Ds, Wwr, Gs^Fp, Gs, Gg^Efm, Gg, Gg, Gg, Gs, Gg^Efm, Re, Re, Gd, Rr, Rr, Rr, Re, Re, Gs^Efm, Re, Re, Gg^Efm, Aa^Esa, Gg^Esa, Gg, Gs^Fp, Md, Md, Gs^Fp, Gs^Fp
Gs^Fp, Gs, Gs^Fp, Gs^Fp, Gs^Fp, Gs^Fp, Gs^Fp, Hhd^Fp, Hh^Fp, Hh^Fp, Gs^Fp, Gg^Ve, Gs^Fp, Gll, Gg^Efm, Gs, Gs^Fp, Gll, Wo, Wo, Gs^Emf, Gs, Gg, Gs, Gs^Ve, Re, Rr, Rr, Gs, Gs, Gs, Gs, Gd^Esa, Gd^Esa, Gd^Esa, Gg, Gg, Gs, Re^Es, Gs, Gs, Gg, Gg, Gs^Fp, Gs^Fp, Gs^Fp, Gg, Gs^Fp
Gs^Fp, Gs^Fp, Hh^Fp, Hh^Fp, Gs^Fp, Gs^Fp, Gs^Fp, Hh^Fp, Gs^Fp, Gs^Fp, Gd, Gd^Edt, Gd, Gd, Gg, Gs, Gll, Wo, Ds, Gs^Fp, Gs^Em, Gs^Em, Gg, Re, Re, Rr, Gs^Edt, Gs, Gg, Gll, Gg^Efm, Aa, Aa^Esa, Aa^Esa, Gd, Gs, Gd^Ecf, Re, Chr, Re, Gd^Edt, Gs, Gs, Gg, Gg^Efm, Gg, Gg^Efm, Gg
Gs^Fp, Gs^Fp, Gg^Ve, Hh^Fp, Hh^Fp, Gs^Fp, Gs^Fp, Gs^Fp, Gll, Gs^Fp, Gll, Gll^Edt, Gs^Fp, Gs^Fp, Gll, Gs, Gd^Fp, Ww, Ds, Gs, Gg, Gg^Em, Gll, Gs, Re, Gs^Edt, Gg, Aa^Esa, Gs, Gg, Gg, Gg^Efm, Gs^Edt, Gd, Gs, Gs, Gd, Rr, 1 Khr, Chr, Gd^Edt, Gll, Gs, Gg, Gg^Efm, Gs^Efm, Gs^Fp, Gs
Gg, Gs^Fp, Gll, Hh^Fp, Gs^Fp, Gs^Fp, Gs^Fp, Gs^Fp, Gd, Hhd^Fp, Hhd^Fp, Gll, Gll, Gll, Gs^Fp, Gd^Fp, Ds, Ww, Ds, Gd, Gd, Gd, Gs^Edt, Gs, Re, Re^Es, Gg, Gg, Gs^Efm, Gs, Gd^Edt, Gd^Edt, Gs, Gs, Gg^Efm, Aa, Gd, Chr, Chr, Chr, Gs^Edt, Gs, Gg^Efm, Gg, Gs^Fp, Gs^Fp, Hh, Gs^Fp
Gs^Fp, Gll^Edt, Gs^Fp, Gs^Fp, Gs^Fp, Gs^Fp, Gg^Ve, Gd, Gs^Fp, Gd, Hhd^Fp, Gs^Fp, Gs, Gs^Fp, Gd^Fp, Ds, Wwf, Wwr, Gs^Fp, Gg, Gg, Gg, Gs, Gd, Gs^Fp, Rr, Gg^Ve, Gs, Gs, Gs, Gs, Gs^Edt, Gg, Gg, Gs^Efm, Aa^Esa, Aa^Esa, Gs^Edt, Gs^Edt, Gs^Edt, Gs, Gs, Md, Gg, Hh^Em, Gs^Fp, Md, Hh
Gd, Gll, Gs^Fp, Gs^Fp, Gll, Gs^Fp, Gll^Em, Gs, Gs^Fp, Hh^Fp, Gs^Fp, Gs^Fp, Gs, Gd, Ww, Ww, Wwr, Wwr, Hh^Fp, Gs^Fp, Gg, Gg^Efm, Gs, Gd, Gs^Fp, Rr, Gs, Gg, Gs, Gg, Gd, Gg, Gg, Gs, Gg, Gs^Efm, Gg, Gg, Gg, Gg, Gg, Gg^Em, Hh, Hh^Emf, Md, Hhd, Hhd, Md
Ds, Gd, Gs^Fp, Gs, Ds, Gll, Gs^Em, Gs^Em, Gs^Fp, Gs^Fp, Gs, Gd, Gd^Fp, Ww, Ds, Ds, Gs^Emf, Gs^Fp, Gs^Fp, Gg, Gg^Efm, Gg^Efm, Gs, Gs^Fp, Re, Re, Gs^Edt, Gs, Gs^Fp, Gs, Gs^Fp, Gd^Edt, Gll^Edt, Gg, Gs, Gg, Gs, Gs, Gll, Hhd^Em, Hh^Em, Mm, Mm, Mm^Em, Mm, Mm, Mm, Hhd
Ww^Wkf, Wwr, Wwr, Ww, Ww, Ww^Ewl, Ww^Ewl, Gll, Ds, Gd, Ds^Ewsh, Ds, Wwr, Ww, Ds, Gs^Fp, Gs^Em, Gs^Fp, Gg, Gg, Gll, Gs, Re^Es, Re, Gs, Gs, Gs^Fp, Gs^Fp, Gs^Fp, Gs^Fp, Hh, Gs^Fp, Gd, Gll, Hhd^Em, Gs, Md, Gs, Hh, Hh, Hh^Vhh, Mm, Mm, Hh^Em, Hh^Dr, Mm, Hh, Ww
Ww^Wkf, Ww^Ewl, Wwr, Ds, Ds, Ww^Wkf, Ww^Wkf, Ww^Wkf, Ww, Ds, Ww, Wwr, Ds, Wwr, Ds, Gs, Gs, Gs^Em, Gs^Em, Gg^Efm, Gg, Gs, Re, Gg^Efm, Gg, Gs, Gs^Fp, Gs^Fp, Md, Hhd^Em, Md, Gs^Fp, Gs^Fp, Hhd^Emf, Mm, Hhd, Gs, Gs^Em, Mm, Mm, Hh^Dr, Md, Hhd^Em, Md, Mm, Mm, Md, Hh
Ds, Ww^Wkf, Ds, Ds^Ewsh, Ds, Ds^Es, Ds^Es, Ds^Es, Wo, Ww, Ds, Ww, Ww, Ds, Gs^Em, Gs, Hh^Fp, Hh^Fp, Gs^Fp, Gs, Gd, Gs, Rr, Gg^Efm, Gs, Gs^Fp, Hh, Md, Hhd^Dr, Hhd^Dr, Md, Md, Gs^Fp, Gg^Efm, Mm, Hh^Vhh, Gg, Gs^Em, Hh^Em, Mm, Hh^Dr, Mm, Hhd, Mm, Mm, Mm, Hh, Hhd
Ww, Ds^Ewsh, Ds, Ds, Ds, Ds, Ww^Wkf, Ww^Ewl, Ww^Ewl, Ww^Ewl, Ds, Wwf, Ww, Ww, Gs^Em, Gd, Gs^Fp, Gs^Fp, Gg, Gs^Fp, Gd, Gd^Em, Re, Gg^Efm, Gs, Gs^Fp, Hhd, Md, Hhd^Em, Md, Gs^Fp, Gs^Fp, Gs, Gg^Efm, Gg^Efm, Gg, Gs, Md, Hh, Hh^Dr, Hh^Em, Hhd, Hh, Mm, Mm, Hh, Hh, Ww
