Gs, Gs, Gg, Gg, Gg, Gg, Gg, Gg, Gg, Gg, Gg, Gg, Gs, Gg, Aa, Gg, Gd, Gs, Aa, Gg, Gs, Gg, Gg, Gg, Gd, Gg, Re, Gg, Gg, Re, Re, Gg, Gg^Efm, Re, Gs, Gg, Gg, Gg, Gs, Gs, Gs, Gs, Gd, Gg, Gg, Gg, Gs, Gs
Gd, Gg^Efm, Gg^Efm, Gg^Efm, Gs, Gg, Gs, Gg, Gd, Gd^Em, Gd, Gd, Gs, Gg, Gg, Gs, Gs, Gs, Aa, Gs, Gd, Gg, Gs, Gg, Gs, Gd, Re, Gs, Gs, Gs, Gg^Efm, Re, Re, Re, Gs^Edp, Gs, Gs, Gs, Gs, Gs, Gs^Edp, Gd, Gs, Gg, Gg^Efm, Gg, Gd, Gs^Fms
Gs, Gs, Gs, Gd, Gs^Edp, Gs, Gg, Gg^Vh, Gg, Gg, Aa, Mm, Aa^Vha, Mm, Mm, Aa, Mm, Mm, Aa^Vha, Gs, Mm, Gg, Gs, Gg, Gg^Es, Gs, Gs, Re, Re, Gs, Gg^Efm, Gd, Re, Gs, Gs, Gs, Gs, Gs^Edt, Gs, Gd, Gs, Gs, Gd, Gs^Fms, Gd, Gd, Gs^Fp, Gs^Fp
Ww, Gs, Gs, Gd, Gs, Gg, Gs^Es, Gs, Gs, Gd, Gg^Efm, Mm, Aa, Aa, Ch, Rr, Ch, Aa, Mm, Aa, Gs, Gg, Gs, Gs, Gs, Gg, Gg, Gs, Re, Gd, Gs, Re, Gs, Gs, Gs, Gd, Gs, Gs, Gg, Gg, Gs, Gs, Gd^Efm, Gd, Gs^Fds, Gs^Fds, Gs^Fp, Gd
Ww, Ww, Ww, Gd, Ww, Gs, Ww, Gg, Gg^Efm, Gg^Efm, Gg, Mm, Aa, Hh, Ch, 2 Kh, Ch, Mm, Aa, Gs, Gg, Gs, Gs^Edt, Gs, Gg^Edt, Gg, Gs, Gs, Gg^Efm, Re, Re, Re, Gs, Gg^Efm, Gs, Gs, Gs, Gg, Gg, Gs, Gs^Fms, Gs, Gd, Gs^Fds, Gs^Fp, Gs^Fms, Gs^Fp, Gs^Fp
Ww, Ww, Ww, Ww, Ww, Ww, Ww, Ww, Ww, Gg, Gg, Gg^Efm, Gg^Efm, Mm, Hh, Ch, Aa^Vha, Hhd, Hh^Em, Gg, Gs, Gd^Edt, Gs, Gg^Edt, Gd^Em, Gg^Edt, Gs, Gd, Re, Re, Gs, Gs, Gs, Gs, Gs, Gg, Gg, Gg, Gs^Fms, Gs^Fms, Gs^Fp, Gg, Gs^Fp, Gs^Fp, Mm, Gs^Fms, Gs^Fp, Hh
Gs, Gs, Ww^Bw\, Wo, Wo, Ww, Wo, Ww, Wo, Ww, Ww, Gd, Gg^Efm, Hhd, Hhd, Mm, Hhd, Aa, Aa, Gg^Edt, Gs, Gs, Gs, Gs, Gs, Gs, Gs, Gs, Re, Gs, Gg, Gs, Gs, Gs, Gs, Gs, Gs, Gs^Efm, Gs^Fp, Gs^Fp, Gs^Fp, Gs^Fp, Gs^Fp, Mm, Mm^Xm, Gs^Fp, Hhd, Hh
Ww, Gg^Efm, Ww, Ww, Wo, Wo, Wo, Wo, Wo, Wo, Wo, Ww, Gs, Aa, Aa^Vha, Hhd, Aa, Hhd, Mm, Gs, Gs, Gs, Gs, Gs^Edp, Gs, Gs, Gs, Gg^Vh, Re, Gs, Gs, Gs, Gg, Gs, Gg, Gs, Gs, Gs, Gs^Fp, Gs^Fp, Gs^Fp, Gs, Gs^Fp, Mm, Mm, Mm, Gg, Gg^Efm
Gg, Ww, Ww, Wo, Wo, Ww, Ww^Bw\, Ww, Ww, Ww, Ww^Bw\, Ww, Gs, Gs, Gs, Gs, Gd, Gs, Gs^Edt, Gs, Gs^Edt, Gg^Edt, Gs, Gs, Gs, Gd, Gs, Re, Re, Gs, Gg, Gg, Gg^Edt, Gg, Gs, Gs, Gs, Gd, Gd, Gd, Gd, Gs^Fp, Gs^Fp, Mm, Hh, Hh, Mm, Mm
Gd, Gs, Gs, Ww, Ww, Ww, Gg^Efm, Gg^Em, Ww^Bw\, Ww, Gs, Gg^Ve, Gs, Gg^Edt, Gg, Gs, Gs^Es, Gs, Gs, Gg^Edt, Gs, Gs, Gs, Gs, Gg, Gd, Gs, Gs, Re, Gs, Gs, Gd^Es, Gg, Gg, Gs, Gg^Dr, Gs, Gd, Gs^Es, Gs^Fms, Gs, Gs^Fp, Gs^Fp, Gs, Hhd, Hhd, Gs^Fp, Gs^Fp
Gg, Gg, Gs, Gg, Gs, Gg^Efm, Gs, Ww, Gs, Gg^Em, Gs, Gs, Gd^Edt, Gs, Gs^Fds, Gg, Gg, Gs, Gs, Gs, Gs, Gs, Gg, Gg, Gg^Vh, Gg, Gs, Gs, Gg, Re, Gs, Gs, Gg^Es, Gs, Gs, Gs, Gs, Gg^Es, Gs, Gs^Es, Gs^Es, Gs^Fp, Gs^Fds, Gs^Fp, Hhd, Gs, Gs^Fp, Ds
Gs^Fp, Gg, Gs, Gd, Gd^Es, Gd, Gg^Efm, Gs, Gs, Gs, Gs^Fp, Gs, Gs, Gs, Gg^Vh, Gs^Fp, Gg, Gs, Gs, Gs, Gs^Efm, Gs, Gs, Gs, Gs, Gs, Gs, Gs, Gs, Re, Gs, Gs, Gs, Gd, Gs, Gs, Gs, Gs, Gg^Edt, Gg^Edt, Gs^Fms, Gs^Fp, Gs^Fms, Gs^Fms, Gs^Fp, Gs^Fp, Ds, Ds
Gs^Fp, Gs, Gs, Gs^Fp, Gs^Fms, Gs, Gs, Gs^Fp, Gs, Gs, Gs, Gs, Gs, Gs, Gs, Gg, Gs, Gs, Gs, Gd, Gd^Efm, Gs, Gs, Gg^Dr, Gs, Gs, Gs, Gd, Gs, Re, Re, Gd, Gs, Gs, Gs, Gs, Gs, Gg^Edt, Gg, Gg^Edt, Gs, Gs^Fms, Gs, Gs, Gs^Fp, Gs^Fp, Ww, Ww
Gg, Gs, Gg, Gs, Gs, Gs^Fds, Gs, Gs, Gd, Gs, Gs, Gs^Es, Gg, Gs, Gg^Edt, Gs^Fp, Gs, Gs, Gg, Gs, Gs, Gs, Gs, Gs, Gg^Wm, Gs^Efm, Gd, Gd^Es, Gs, Gg, Re, Gd, Gd, Gs, Gs, Gs, Gs, Gs, Gs^Es, Gd, Gg, Gs, Gs^Fds, Gs^Fp, Gs^Fp, Wo, Ww, Ww
Gs, Gs, Gs, Gg, Gs^Fp, Gs, Gs, Gs, Gs, Gs^Fds, Gs, Gs, Gd^Edt, Gd^Edt, Gd, Gs, Gs, Gs, Gg, Gg, Gg, Gg^Edt, Gg^Edt, Gg^Edt, Gs, Gs, Gd^Edt, Gs, Gs, Gg, Gg, Re, Gd, Gs, Gs, Gg, Gs, Gs, Gg^Em, Gs, Gs, Gs, Gs^Fp, Gs^Fp, Ww, Ww, Ds, Ds
Gs, Gd, Gd, Gd, Gs, Gs, Gs, Gs, Gs, Gs^Fp, Gg^Efm, Gd, Gg^Edt, Gg^Fet, Gg, Gd, Gg^Vh, Gs^Fp, Gs^Fp, Gs^Fp, Gs^Fp, Gg^Es, Gs, Gs^Em, Gs, Gs, Gs^Edp, Gs, Gd, Gs, Gg, Re, Gg, Gd, Gs, Gs, Gs, Gs, Gs, Gs, Gd, Gs, Ww, Ww, Ds, Ww, Ww, Ds
Gs^Fp, Gg, Gg^Ve, Gd, Gs^Fp, Gs, Gs^Efm, Gs, Gs, Gs, Gs, Gs^Edt, Gs, Gg, Gg, Gg, Gs^Fp, Gs^Fp, Gs, Gg^Efm, Gs, Gs, Gs, Gs, Gg, Gs, Gs, Gs, Gs, Gs, Re, Re, Gg^Ve, Gg, Gs, Gg^Es, Gs, Gs, Gs, Gs, Gd, Gs, Ww, Ds, Gs, Ds, Ww, Ww
Gg, Gs^Fp, Gs^Fp, Gs^Fp, Gs, Gs, Gs^Fms, Gg, Gs^Fms, Gs, Gs, Gs, Gg^Efm, Gg, Gs^Fds, Gg, Gd, Gs, Gs, Gs, Gs, Gs^Fp, Gs, Gs, Gs, Gs, Gs, Gd, Gg, Gs, Re, Re, Gs, Gg, Gs^Es, Gs, Gs, Gg^Ve, Gd, Gd, Gs, Gd, Ww, Ds, Gs, Ds, Ds, Ww
Gs^Fp, Gs^Fp, Gs^Fp, Gs^Fp, Gs^Fp, Gs^Efm, Gs^Fms, Gs^Fp, Gs^Fp, Gs^Fms, Gs^Fms, Gg, Gg, Gg, Gs, Gs, Gd, Gs, Gs^Fp, Gs, Gs, Gs, Gg^Vh, Gs, Gs^Edp, Gs, Gs, Gs, Re, Re, Gg, Gs, Gs, Gs^Es, Gs^Es, Gs, Gs, Gs, Gd, Gg^Edt, Ds, Ds, Ww, Gs^Edt, Gs, Gg^Efm, Ds, Ww
Gs^Fp, Gs^Fms, Gs^Fp, Gg^Fet, Gs^Fp, Gs^Fp, Gs^Fp, Gs^Fp, Gs^Fp, Gs^Fp, Gs^Fp, Gs^Fds, Gs, Gs^Fms, Gg^Es, Gg^Es, Gg^Es, Gg^Es, Gg, Gg, Gg^Efm, Gg^Efm, Gd^Efm, Gs, Gs, Gs, Gg^Es, Gs, Re, Gg^Ve, Gg, Gg, Gg, Gs, Gg, Gs, Ds, Gd, Ww, Ww, Ww, Ww, Gs^Edt, Gs^Edt, Gg, Gg, Gs, Ds
Gs^Fp, Gs, Gs^Fp, Gs^Fms, Gs^Fp, Gs^Fp, Gs^Fp, Gs^Fp, Gs^Fp, Gs^Fp, Gs^Fp, Gs^Fms, Gd, Gs, Gs, Gg^Es, Gs^Fmw, Gg, Gg^Edt, Gg, Gs^Fds, Gg^Efm, Gs, Gs, Gs, Gs^Es, Gg^Es, Gs, Re, Re, Ww, Ds, Ds, Gs, Ds, Ds, Ww, Ww, Gd, Gd, Gs, Gd^Edt, Gs, Gg, Gg, Gs, Gs^Em, Gs
Gs, Gs, Gs^Fms, Gs^Fms, Gs^Fp, Gg^Ve, Gs, Gs^Fp, Gs^Fp, Gs^Fp, Gs, Gs^Fp, Gs^Fp, Gd^Esd, Gg^Efm, Gg^Fmw, Gs^Fmw, Gg^Efm, Gd^Edt, Gg^Edt, Gs, Gs, Gg, Gg, Gg^Edt, Gg, Gg^Es, Re, Ww^Bw\, Ww^Bw|, Ds, Ww, Ds, Ds, Ds, Ds, Ww, Gg^Efm, Gs, Gs, Gs, Gs, Gs, Gg, Gs, Gs, Gs, Gs
Gs^Fp, Gs^Fp, Gs^Fds, Gs^Fp, Gs^Fp, Gs^Fp, Gs^Fp, Gs^Fp, Gs^Fp, Gs^Fp, Gs^Fp, Gs^Fmw, Gs, Gs, Gg, Gs, Gs, Gg^Efm, Gd^Edt, Gs, Gs^Fp, Gg^Efm, Gg^Efm, Gg, Gg, Gg, Wo, Ww, Gg^Ve, Re, Gg, Ww, Ww, Ww, Ww, Ds, Ww, Gg^Efm, Gs, Gs^Edp, Gg, Gs, Gd, Gs, Gs, Gs, Gs, Gs
Gs^Fp, Gs^Fp, Gs^Fms, Gs^Fms, Gs^Fmw, Gs^Fp, Gs^Fds, Gs^Fp, Gs^Fms, Gs^Fmw, Gs^Fmw, Gs^Fms, Gs^Fmw, Gs^Fmw, Gg, Gs, Gg, Gd, Gs, Gs, Gs, Gg, Gg, Gg, Wo, Wo, Ww, Ww, Re, Re, Gg, Gs, Gs, Gs, Gg, Ww, Ww, Gg, Gs, Gs, Gd^Es, Gd, Gs, Gs, Gg, Gg, Gg^Efm, Gg
Gs^Fp, Gs^Fms, Gs^Fp, Gs^Fp, Gs^Fms, Gs^Fp, Gs^Fds, Gs^Fp, Gs^Fp, Gs^Fp, Gs^Fmw, Gs^Fmw, Gg, Gg, Gg, Gg^Ve, Gg, Gg, Gg, Gs, Gg, Gs, Ww, Ww, Ww, Ww, Gs^Em, Gs, Re, Gg, Gs, Gs, Gs, Gg, Gg, Gg^Es, Ww, Gg, Gg, Gs, Gs^Edp, Gs, Gs, Gs, Gg, Gd, Gs, Gg
Gs^Fms, Gs^Fms, Gs^Fp, Gs^Fp, Gg^Fet, Gs^Fds, Gs^Fp, Gs^Fp, Gs^Fp, Gs^Fp, Gs^Fp, Gs^Fds, Gs^Fds, Gs, Gs, Gg, Gd^Es, Gg^Es, Gs^Fp, Gg^Vh, Gg, Ds, Ww, Ds, Gs, Gs, Gg, Gs, Re, Gs, Gg, Gs, Gs, Gs, Gs, Gg, Gg, Ww, Ww, Gs, Gs, Gs, Gg, Gg, Gs, Gs, Gs, Gg
Gg, Gs^Fms, Gs^Fp, Gs^Fms, Gs^Fds, Gs^Fds, Gs^Fds, Gg^Efm, Gg^Efm, Gg^Ve, Gs, Gs^Fp, Gs^Fds, Gs, Gs, Gs, Gd, Gd^Es, Gs, Gs, Ds, Ww, Gs, Gg^Efm, Gs^Efm, Gg, Gg, Gg, Re, Gs, Gg, Gs, Gg, Gs, Gs, Gg, Gg, Gg^Efm, Gg^Efm, Ww, Ww, Gs, Gs, Gs, Gs, Gs, Gs, Gg
Gs^Fp, Gs^Fp, Gs^Fms, Gs^Fms, Gs^Fp, Gs, Gd, Gs, Gg^Efm, Gs, Gs, Gs, Gs^Fds, Gs, Gs, Gs^Fp, Gs, Gs, Ww, Ds, Ww, Ww, Gd, Gd^Edt, Gd, Gg, Gg, Gg, Re, Gs, Gd, Gd, Gd, Gd^Em, Gd, Gs, Gs, Gs, Gs, Gg^Efm, Gs, Ww, Ww, Gs, Gd, Gs, Gs^Es, Gg
Gs^Fp, Gs^Fp, Gs^Fms, Gs^Fms, Gd, Gs^Fp, Gs^Fp, Gs^Fds, Gg^Efm, Gg^Efm, Gs, Gd^Em, Gs, Gs, Gg^Es, Gs, Gs, Ww, Wo, Ww, Ww, Gs, Gs, Gg, Gg, Gg, Gs^Efm, Gg, Re, Gs, Gs, Gs, Gg, Gs, Gd, Gs, Gs, Gs^Edp, Gs, Gs, Gs, Wo, Ww, Gs, Mm, Gs, Gs, Gs
Gs^Fp, Gs^Fp, Gg^Ve, Gg, Cv, Gg, Gs, Gs^Fds, Gs^Fds, Gs^Efm, Gs, Gs^Fp, Gs, Gs^Fms, Gs, Gs, Gs^Fms, Ww, Ds, Wo, Ds, Gs, Gd, Gg, Gg, Gg, Gg^Dr, Gs, Re^Es, Gg, Gs, Gs, Gg, Gg, Gg, Gg^Efm, Gs, Gs, Gd, Gs, Gg, Gg, Mm, Ww, Hhd^Vhhr, Mm, Gd, Gs
Gs^Fp, Gs^Fp, Gs^Fp, Cv, Cv, Cv, Gd^Em, Gs^Fp, Gs^Fds, Gs, Gs^Fds, Gs, Gg^Edt, Gs^Fp, Gg, Gg^Ve, Gs^Fp, Ww, Ww, Ds, Gg, Gd, Gg^Edt, Gg, Gs^Edt, Gg, Gs, Gs, Gs, Re, Re, Gs, Gg, Gg, Gs, Gg, Gs, Gs, Gs, Gs, Gs, Gg, Mm, Ww, Hh, Hhd, Gd, Gs
Gs, Gg^Efm, Cv, 3 Kv, Gs^Fp, Gs^Fp, Gs^Fms, Gs^Fms, Gs, Gs, Gg^Efm, Gs^Fds, Gs^Fms, Gs, Gg, Gs^Fp, Gs^Fds, Ww, Ww, Ds, Gs, Gs, Gg, Gg^Edt, Gg, Gg, Gg^Efm, Gs, Gg, Gg^Ve, Re, Gs, Gs, Gs, Gs, Gs, Re, Gs, Gg^Edt, Gs, Gs, Gs, Gs, Mm, Mm, Mm, Mm, Gg
Gs, Gs, Gg^Ve, Gs^Fp, Gs^Fp, Gs^Fms, Gs^Fms, Gs^Fp, Gg^Efm, Gs, Gs^Fp, Gs^Fms, Gs^Fp, Gs, Gg^Efm, Gg^Efm, Gg^Efm, Gs^Fms, Gg, Ww, Gs, Gs, Gg, Gg, Gs, Gs, Gs, Gg^Efm, Re, Re, Gs, Re, Re, Re^Es, Re, Re^Edt, Gg^Edt, Re^Edt, Re, Gs, Gd, Gs, Gs, Gg^Em, Mm, Mm, Gs, Gs
Gs^Fp, Gs, Gs^Fp, Gs^Fp, Gs^Fp, Gs^Fms, Gs^Fp, Gs^Fp, Gs^Fp, Gs^Fp, Gs^Fp, Gs^Fp, Gs^Fp, Gs, Gs, Gd, Gs^Fp, Gd, Ww, Ww, Gs, Gg, Gg, Gg, Gg^Ve, Re, Re, Re, Gs, Gd^Edp, Gd, Gd, Gd, Gs, Gg, Gg, Gs^Ecf, Gs, Re, Gg, Gg^Edt, Gs, Gs, Gs, Gs, Gs, Gs, Gg
Gg^Fet, Gs^Fp, Gs^Fp, Gs^Fp, Gs^Fms, Gs^Fp, Gs^Fp, Gs^Fp, Gs^Fds, Gs^Fp, Gg, Gg, Gs, Gd, Gg, Gs, Gs^Fp, Ww, Ds, Gg, Gg^Efm, Gg^Efm, Gg, Re, Re, Re, Gg, Gg, Gg, Gs, Gs, Gs, Gg^Es, Gg, Gg, Gg, Gg, Re, Re, Re^Edt, Gg^Edt, Gs, Gs, Gs, Gg, Gs, Gs, Gg
Gs^Fp, Gs^Fp, Gg^Ve, Gs^Fms, Gs^Fmw, Gs^Fp, Gg^Fet, Gs^Fp, Gs, Gs^Fp, Gg, Gs^Es, Gs^Fms, Gs^Fp, Gs, Gd, Gd, Ww, Ds, Gg^Efm, Gd^Es, Gg, Gg, Gd, Re, Gs, Gs, Gs, Gs, Gs, Gs, Gs, Gg^Es, Gs, Gg^Edt, Gg^Edt, Gs^Edt, Chr, 1 Khr, Chr^Edt, Gg, Gg^Edt, Gs^Edt, Gd, Gs^Es, Gs, Gs, Gs
Gg, Gs^Fp, Gs, Gs^Fms, Gs^Fmw, Gs^Fmw, Gs^Fp, Gs^Fp, Gs, Gs^Fp, Gs^Fp, Gg, Gg, Gg, Gs^Fms, Gs^Fms, Ds, Ww, Ds, Gg^Efm, Gg, Gd^Es, Gd^Es, Gg, Re, Re^Es, Gs, Gs, Gg, Gs, Gs, Gg^Es, Gg, Gs, Gs, Gs, Gs^Edt, Chr, Chr^Edt, Chr, Gg, Gg, Gs, Gs, Gs, Gs, Hhd, Gs
Gs^Fp, Gs^Efm, Gs^Fms, Gs^Fms, Gs^Fmw, Gg^Ve, Gd^Es, Gs, Gs^Fp, Gs, Gs^Fp, Gs^Fp, Gg, Gs^Fms, Gs^Fms, Ds, Wo, Ww, Gs, Gs^Efm, Gg, Gg, Gd, Gd, Gg, Re, Gg^Ve, Gs, Gs, Gs, Gs, Gs, Gd, Gg, Gs, Gs^Edt, Gd, Gs^Edt, Gd, Gg^Edt, Gg, Gs, Hhd, Gs, Hhd^Em, Gg, Mm, Hh
Gg, Gs, Gs^Fp, Gs^Fp, Gg^Efm, Gs^Fp, Gg, Gs, Gs^Fms, Gs^Fp, Gs^Fds, Gs^Fp, Gg, Gg, Ww, Ww, Ww, Ww, Gs, Gg, Gd^Es, Gg, Gg, Gg, Gs, Re, Gs, Gg, Gg, Gs, Gs, Gd, Gd, Gg, Gg, Gs^Edt, Gd, Gd, Gg, Gg, Gg, Gg, Hhd^Em, Hhd^Em, Mm, Hhd, Hh, Mm
Ds, Gg, Gs^Fp, Gg^Efm, Ds, Gg^Efm, Gg^Efm, Gs, Gs^Fp, Gs^Fp, Gg, Gg, Gs^Fp, Ww, Ds, Ds, Gg, Gs, Gg^Em, Gg, Gg, Gg, Gs, Gs, Re^Es, Re, Gg, Gg, Gs, Gs^Efm, Gd, Gd^Dr, Gg, Gg, Gs, Gs, Gs, Gg^Efm, Gg^Efm, Hhd^Em, Hhd^Em, Mm, Mm, Mm, Mm, Mm^Xm, Mm, Hh
Ww, Ww, Ww, Ww, Ww, Ww, Ww, Gd, Ds, Gg, Ds, Ds, Ww, Ww, Ds, Gg, Gd^Em, Gd^Em, Gg, Gg, Gs, Gg, Re, Re, Gs, Gs, Gs, Gs, Gs^Efm, Gs^Edp, Gs^Efm, Gs^Efm, Gs^Efm, Gs, Gs, Gs, Gs, Gg^Efm, Hhd^Em, Hh, Hhd^Vhhr, Mm, Mm, Hhd^Em, Hhd^Em, Mm, Hhd^Em, Hhd^Em
Ww, Wo, Wo, Ds, Ds, Ww, Ww, Ww, Ww, Ds, Ww, Ww, Ds, Ww, Ds, Gg, Gg, Gs, Gg, Gg, Gg, Gs, Re, Gs, Gd^Es, Gd^Es, Gs, Gs, Gs, Gs^Efm, Gs, Gs, Gs, Gs, Gs, Gs, Gs^Efm, Gg^Efm, Mm, Mm, Hh, Mm, Hhd^Em, Mm, Mm, Mm, Mm, Hhd^Em
Ds, Wo, Ds, Ds, Ds, Ds, Ds, Ds, Ww, Ww, Ds, Ww, Ww, Ds, Gs, Gg, Gs, Gs, Gg, Gg^Edt, Gg, Gs, Re, Gs, Gg, Gs, Gs, Gg, Gs, Gs, Gs, Gs, Gs, Gg, Gg, Gg^Efm, Gs, Gs, Hhd^Em, Mm, Hhd^Em, Mm, Hhd^Em, Mm, Mm, Mm, Hhd^Em, Hhd^Em
Ww, Ds, Ds, Ds, Ds, Ds, Ww, Ww, Wo, Wo, Ds, Wo, Ww, Ww, Gs, Gs, Gd, Gd^Em, Gg, Gs, Gs, Gg, Re, Gg, Gg, Gg, Gs, Gs, Gs, Gs, Gg, Gs, Gs, Gg, Gs, Gs, Gs, Hhd^Em, Hh, Hhd, Hhd, Mm^Xm, Hhd^Em, Mm, Mm, Hhd, Hh, Hhd^Em
