Gg, Hh, Hh^Fdw, Hh, Mm, Rp, Rr, Hh^Fdw, Mm, Mm, Mm, Hhd, Mm, Mm, Mm, Hhd, Mm, Mm, Mm, Ds, Ww^Ewl, Wo, Wo, Ww, Ds, Re, Re, Mm, Mm, Md^Xm, Mm, Mm, Mm, Mm
Hh, Gg, Gs, Mm, Mm, Mm, Mm, Rr, Rr, Mm, Mm, Mm, Mm, Mm, Mm, Mm, Mm, Mm, Hh^Fdw, Ds, Ww^Ewl, Wo, Wo, Ww^Wkf, Ds, Ds, Re, Hh^Fdw, Mm, Mm, Mm, Mm, Mm, Mm
Gs, Mm, Gs, Rr^Es, Rr, Mm, Mm, Mm, Hh^Fdw, Mm, Mm, Mm, Mm, Mm, Mm, Mm, Hh^Fdw, Hh, Gs, Ds, Ww^Ewl, Wo, Ds, Ww, Ds, Re, Mm, Mm, Mm, Mm, Hh, Mm, Hh, Mm
Hh^Fmw, Gs, Gd, Gd^Vhr, Hh^Em, Rr, Mm, Mm^Xm, Mm, Hh, Hh^Em, Mm, Mm, Mm, Gs, Gs^Fmw, Gg, Gg, Ds, Ds, Ww^Bw\r, Ww^Wkf, Ds, Ds, Re, Re, Hh, Mm, Mm, Mm, Mm, Hh, Hh, Hh
Hh, Hh^Em, Hh, Hh, Hh^Fp, Chr, Chr, Mm, Hh^Fdw, Hh^Fmw, Hh^Emf, Mm, Mm, Mm, Gs^Fdw, Gg, Wo, Wo, Ww, Ww^Bw\r, Rr, Re, Re, Re, Cvr, Mm, Mm, Hh, Hh^Fdw, Mm, Mm, Mm, Hh, Mm
Mm, Mm^Xm, Mm, Hh^Fdw, Hh, Chr, 1 Khr, Chr, Hh, Gs^Fdw, Gs^Fp, Hh^Em, Gg, Gg, Gs^Fdw, Wwf, Ds, Wo, Ww^Ewl, Ww^Ewl, Gs^Fdw, Rr, Rr, Cvr, 4 Kvr, Cvr, Hh, Hh^Fdw, Gs, Hh^Fp, Hh, Hh, Hh, Hh
Hh, Mm, Hh^Fdw, Hh, Re, Chr, Re, Chr, Re, Gs, Gs, Gg, Gg, Hh, Hh^Fdw, Gs^Fdw, Ds, Wwf, Ww^Ewl, Ds, Gd^Efm, Gg, Rr, Gs^Fp, Cvr, Cvr, Hh, Mm, Gg, Gg^Fp, Mm, Hh, Mm, Hh
Ds, Ds, Ds, Re, Gs, Gs, Gd^Ecf, Re, Gd, Gd^Vhr, Gs^Efm, Gg, Hh^Em, Mm, Mm, Gg, Ww^Bw\r, Ww^Wkf, Gg, Gd, Gs, Gd^Ve, Gg, Rr, Gs, Mm, Gs, Hh, Gd, Gs^Fdw, Hh, Mm, Hh^Fp, Gg
Ww, Wo, Wo, Ds, Gg, Mm, Gd, Gg, Gg, Hh^Fdw, Hh^Fp, Hh^Fdw, Mm, Mm, Wwr, Ww, Ww^Wkf, Gg, Mm, Gs, Gs, Gd, Gg, Rr, Hh, Gd^Ve, Gd, Gs, Gd, Gd, Hh, Hh^Fdw, Gs^Fdw, Gg
Ww, Ww, Wo, Ww^Wkf, Ww^Wkf, Gs, Wo, Wwr, Gs^Es, Gs, Ds, Ww^Ewl, Ww^Ewf, Ww, Wwr, Wwr, Wo, Gg, Mm, Gd^Fdw, Gd^Fdw, Gs^Es, Re^Es, Re^Es, Rr, Hh^Fdw, Gd^Fdw, Gd^Fp, Gs, Gd, Gd, Hh, Gd, Gg
Ds, Ds, Ds, Ww, Ww^Ewl, Ww^Bw|r, Wwr, Wwr, Hh, Hh^Fdw, Ww, Ww^Ewl, Ds, Ds, Ds, Wo, Ww^Wkf, Wwr, Hh, Mm, Hh^Fp, Gs^Fp, Gs, Gs^Ve, Re, Rr, Re, Gd, Gg, Gs^Wm, Gg, Gs, Gs, Gd
Re, Ds, Ds, Ds, Ds, Gg, Gg, Ww, Ww^Bw|r, Ww, Gg, Ds, Gs, Gs, Gs, Gg, Gs^Fp, Ww, Wo, Hh, Hh, Hhd^Fet, Mm, Gd, Gd, Gd^Efm, Gd, Re, Gs^Fdw, Gg, Hh^Fdw, Gg, Gs, Hh
Gg, Re^Es, Re, Re, Gs^Fdw, Gs^Fdw, Gd^Efm, Gg, Gs^Es, Gs^Es, Mm, Gd, Gs^Fdw, Gg^Es, Mm, Hh^Fp, Gs, Gg, Gg, Wo, Mm, Hh^Em, Hh^Em, Hh, Gs, Gs, Gs, Re, Gs, Hh^Fdw, Mm, Hh^Em, Gs, Hh
Hh^Fdw, Gs, Gd, Mm, Mm, Hh, Re, Gd^Vh, Gs^Es, Mm, Gs, Mm, Gs, Mm, Mm, Mm, Mm, Gs^Fdw, Wwr, Ww^Wkf, Hh, Hh^Emf, Hh^Em, Gs^Fdw, Hh^Fp, Hh^Fdw, Gs^Fdw, Re^Es, Re^Es, Hh, Mm, Hh^Emf, Gd^Em, Gd
Mm, Hh, Mm, Hh^Fp, Hh^Fdw, Hh, Rr, Rr, Gg, Gd^Fdw, Gs, Gs, Hh^Fmw, Hh^Fdw, Mm, Mm, Mm, Hh^Fdw, Hh^Vhhr, Ww^Wkf, Ww^Wkf, Hh^Em, Hh^Emf, Hh^Em, Hh^Fp, Hh, Hh, Gd, Re, Mm, Hh, Hh^Em, Gs, Gd
Hh, Mm, Mm, Mm^Xm, Mm, Hh, Hh, Gs, Gs, Gg, Gs, Hh, Mm, Mm^Xm, Mm, Mm, Hh^Em, Gs^Fdw, Hh^Fdw, Hh, Ww, Hh^Em, Hh, Hh^Em, Gd, Hh, Hh, Gd^Ve, Re^Es, Hh, Mm, Hh, Mm^Xm, Gd
Hh, Hh, Hh^Fmw, Mm, Hh^Fdw, Hh^Fp, Hh, Gd^Fdw, Gs, Gg, Gd^Fdw, Gs, Hh^Fp, Mm, Hh^Em, Hh^Emf, Gs, Rp, Hh, Hh, Hh, Ww, Hh^Fdw, Hh, Gs^Em, Hh^Fp, Gs, Gd, Gd, Re, Re, Mm, Mm, Mm
Mm, Mm, Mm^Xm, Hh^Fp, Mm, Hh^Fp, Hh, Gd, Gs, Gg, Gg, Gd^Fdw, Hh^Fp, Gd^Fdw, Gs, Hh^Em, Gs, Rp, Rp, Hh^Fdw, Hh, Wo, Hh, Hh, Gg, Gg, Gg, Gs, Hh, Mm, Hh, Re, Re, Mm
Hh, Mm, Mm, Mm, Mm, Mm, Hh^Fp, Hh, Hh, Gs, Gd^Vh, Gg, Gd, Hh^Em, Hh^Emf, Gs, Gd, Gg^Wm, Gg, Rp, Ds, Wo, Ww, Hh^Fdw, Ww^Wkf, Wwr, Wwr, Hh^Fdw, Cvr, Cvr, Cvr, Hh^Es, Re^Es, Hh
Hh, Mm, Mm, Hh, Hh, Hh, Hh^Fdw, Hh, Hh, Re, Re, Gd^Es, Gd, Hh^Fdw, Gg, Gs^Em, Gs^Fdw, Gd, Gd^Efm, Gd, Ds, Wwf^Ewl, Ww^Ewl, Ww^Wkf, Wo, Wo, Wwr, Rr, Cvr, 3 Kvr, Mm, Hh^Fp, Re, Mm
Hh, Hh, Mm, Mm, Hh^Fdw, Hh, Hh, Hh, Hh^Fdw, Mm, Hh, Re, Hh, Gg, Gs, Hh^Fdw, Hh^Fmw, Gs^Fdw, Re, Gs, Ds, Wwf, Ww^Ewf, Wo, Wo, Ww, Gg, Rr, Rr, Cvr, Gs^Fp, Mm, Re, Mm
Wo, Hh^Fdw, Mm, Hh^Fdw, Mm^Xm, Hh, Hh, Hh^Fdw, Hh, Hh^Fdw, Hh, Rr, Hh, Hh, Hh, Mm, Hh^Fp, Gs^Fp, Gs^Fp, Re, Ds, Wwf, Wwf^Wkf, Wo, Wwr, Wwf, Gg, Gs, Gd, Gs^Fp, Re, Re, Gg, Gd
Ww^Wkf, Wo, Wwr, Mm, Mm, Mm, Hh^Fdw, Hh, Hh, Hh^Fdw, Rr, Rr, Hh, Mm, Mm, Mm, Hh, Hh^Fdw, Hh, Re, Re, Ds, Gs, Wwf^Wkf, Gs^Fdw, Wwf, Wwf, Gg, Re^Es, Re, Gd, Gd^Ve, Hh, Gg
Ww, Wwr, Ds, Ds, Gg, Hh, Gs, Hh^Fdw, Hh, Mm, Re, Hh, Hh^Fdw, Hh, Mm, Mm^Xm, Mm, Mm, Hh, Hh, Re, Hh^Fdw, Gs, Gs, Gs, Re, Ww^Bw/r, Re, Gd^Ve, Gd^Efm, Hh^Fdw, Hh, Mm, Hh
Ww, Wwg^Bw\, Ds, Gg, Gd, Gs^Es, Gs, Hh, Re^Es, Re^Es, Hh, Hh, Hh^Fdw, Mm, Hh, Mm, Hh, Hh^Fdw, Hh^Fdw, Mm, Hh^Fdw, Mm, Re, Gg^Ve, Re, Re, Ww, Gg, Gs, Gd, Hh, Mm, Mm^Xm, Mm
Ww, Wo, Wwr, Gs, Mm, Gd, Gd, Gd^Vh, Re, Hh^Em, Hh^Fdw, Hh, Hh, Hh^Emf, Hh^Em, Mm, Gg, Mm, Mm, Hh, Hh, Re, Hh^Fdw, Mm, Gs^Fdw, Gs, Wwr, Gg, Gg, Gs, Re^Es, Mm, Mm, Mm
Hh, Ww^Wkf, Mm, Mm, Hh, Hh^Fdw, Gd, Re, Hh, Gd, Mm, Hh^Es, Gs^Em, Gs^Em, Gd, Mm, Rr, Gs, Rr, Hh^Fdw, Hh, Mm, Gg, Gg, Re^Es, Gs^Fdw, Wwr, Ww, Wwf^Ewl, Ds, Ds, Re, Re, Re
Mm, Hh^Em, Hh^Emf, Hh^Em, Hh^Fdw, Hh^Fdw, Gg, Hh, Mm, Mm, Mm, Gs, Mm, Gd^Vh, Gg, Rr, Chr, Chr, Chr, Rr, Gg, Gg, Gs, Re, Re^Es, Gs, Gs^Fp, Gd^Fetd, Wwf^Ewl, Ww, Ww^Bw|r, Ds, Ds, Ds
Hh, Mm, Mm, Mm, Gd, Gs^Es, Mm, Mm, Mm, Mm, Gg, Hh^Fdw, Hh^Em, Gg, Hh, Mm, Chr, 2 Khr, Rr, Mm, Gg, Gd, Gd, Hh, Hh, Re^Es, Re, Re, Ds, Wwf, Ds, Ww, Ww^Wkf, Ww^Wkf
Gg, Hh, Hh^Vhhr, Gs, Hh, Hh^Fdw, Gd^Fdw, Mm, Gs^Fdw, Gs, Gg, Hh^Fdw, Gg, Gg, Re, Mm, Mm, Chr, Mm, Mm, Mm, Gg, Gd^Vh, Gs, Gg, Mm, Mm, Ds, Re, Ds, Hh^Fdw, Ds, Ww^Ewl, Wog
Hh, Gg, Gs, Gs, Re, Re^Es, Re, Gd^Fdw, Hh, Gs, Gs, Gg, Gd, Hh^Fp, Hh^Emf, Re^Em, Hh^Fdw, Hh^Fdw, Hh^Fdw, Mm, Gs, Gg, Gs, Gg, Hh, Mm, Hh, Hh^Fdw, Hh^Fdw, Re, Hh^Fdw, Hh^Fdw, Ww^Ewl, Wo
Hh, Re, Re, Re, Hh, Hh, Hh, Mm, Mm, Mm, Mm, Gs, Gs, Gs, Gs, Hh^Em, Hh, Hh, Gd, Gs, Gd, Gd, Gd, Gg, Mm, Mm, Mm, Hh, Hh^Fdw, Re, Re, Ww, Ww, Ww
