Re, Hhd, Hhd^Fdw, Hhd, Md, Rp, Rp^Fdw, Hhd^Fdw, Md, Md, Md, Hhd, Md, Md, Md, Hhd, Md, Md, Md, Ds, Wwg^Ewl, Wog, Wog, Wog, Ds, Re, Re, Md, Md, Md^Xm, Md, Md, Hhd, Hhd
Hhd, Re, Re^Es, Md, Md, Md, Md, Rp, Rp, Md, Md, Md, Md, Md, Md, Md^Xm, Md, Md, Re^Fdw, Ds, Wwg^Ewl, Wog, Wog, Wog^Wkf, Ds, Ds, Re^Es, Hh^Fdw, Md^Xm, Md, Md, Md^Xm, Md, Hhd
Re, Md, Re^Es, Rp^Es, Rp, Md, Md, Md, Hhd^Fdw, Md, Md^Xm, Md, Md, Md, Md, Md, Hhd^Fdw, Hhd, Re, Ds, Wwg^Ewl, Wog, Ds, Wwg, Ds, Re^Es, Md, Md, Md, Md, Md^Xm, Md, Hh, Hhd
Hhd^Fmw, Re^Fdw, Rb, Gd^Vhr, Hhd^Em, Rp, Md, Md^Xm, Md, Md, Md, Md^Xm, Md, Md, Gll, Gd^Fmw, Gll^Efm, Gll^Efm, Ds, Ds, Wwg^Bw\r, Wwg^Wkf, Ds, Ds, Re^Edb, Re^Es, Hhd, Md, Md, Md, Md, Md^Xm, Md, Hh
Hhd, Hhd^Em, Hhd^Emf, Hhd^Emf, Hhd^Fp, Cer, Ce^Edb, Md, Hhd^Fdw, Hhd^Fmw, Hhd^Emf, Md, Md, Md, Gll^Fdw, Gll^Efm, Wog, Wog, Wwg, Wwg^Bw\r, Rp, Re, Re, Re, Cvr^Edb, Md, Md, Hhd, Hh^Fdw, Md, Md, Md, Md, Md
Md, Md^Xm, Md, Hhd^Fdw, Md, Cer^Edb, 1 Ke, Ce^Edb, Md, Gll^Fdw, Gll^Fp, Hhd^Em, Gll^Efm, Gll, Gll^Fdw, Wwf^Ewl, Ds, Wog, Wwg^Ewl, Wwg^Ewl, Gll^Fdw, Rp, Rp, Cvr^Edb, 2 Kvr, Cvr, Hh, Hh^Fdw, Gll^Fdw, Hhd^Fp, Hhd, Md, Hh, Hh
Hhd, Md, Hhd^Fdw, Hhd^Em, Re, Cer^Edb, Re^Edb, Ce^Edb, Re^Efm, Gd^Efm, Re^Efm, Gll, Re, Hhd, Hhd^Fdw, Gll^Fdw, Ds, Wwf, Wwg^Ewl, Ds, Gd^Efm, Gll, Rp, Cvr^Edb, Cvr^Edb, Cvr, Md, Md^Xm, Gll, Gd^Fp, Md, Md^Xm, Md, Hh
Ds, Ds, Ds, Re, Gd^Efm, Gd^Efm, Gll^Ecf, Re, Gd^Es, Gd^Vhr, Gd^Efm, Re, Hhd^Em, Md, Md, Gll, Wwg^Bw\r, Wwg^Wkf, Gll, Gll^Efm, Gd, Gd^Ve, Gll^Efm, Rp, Gll^Edb, Md, Gll, Hh, Gd, Gd^Fdw, Hh, Md, Hhd^Fp, Gll
Wwg, Wog, Wog, Ds, Re, Md, Re, Gll, Gll^Es, Hhd^Fdw, Hhd^Fp, Hhd^Fdw, Md, Md, Wwrg, Wwg, Wwg^Wkf, Gll, Md, Gd, Gd, Gd^Efm, Gll^Efm, Rp, Hhd, Gd^Ve, Gd, Gll, Gd, Gd, Hhd, Hhd^Fdw, Gll^Fdw, Gll
Wwg, Wwg, Wog, Wwg^Wkf, Wwg^Wkf, Re, Wog, Wwrg, Re^Es, Hhd^Em, Ds, Wwg^Ewl, Wwg^Ewf, Wwg, Wwrg, Sm, Wog, Gll^Es, Md, Gd^Fdw, Gd^Fdw, Gll^Es, Re^Es, Re^Es, Re^Edb, Hhd^Fdw, Gd^Fdw, Gd^Fp, Gd^Efm, Gd, Gd, Gd^Fdw, Gd, Gll
Ds, Ds, Ds, Wwg, Wwg^Ewl, Wwg^Bw|r, Wwrg, Wwrg, Re, Hhd^Fdw, Wwg, Wwg^Ewl, Ds, Ds, Ds, Wog, Wwg^Wkf, Sm, Gll^Es, Md^Xm, Hhd^Fp, Gll^Fp, Gll, Gd^Ve, Re, Re^Edb, Re, Gd, Gll, Gll^Wm, Gll, Gll^Efm, Gd^Efm, Gd
Re, Ds, Ds, Ds, Ds, Gll, Gll, Wwg, Wwg^Bw|r, Wwg, Gll, Ds, Gd^Es, Gd^Es, Gd^Es, Gll, Gll^Fp, Wwg, Wog, Gll^Em, Gll^Em, Hhd^Fet, Mm, Gd, Gd, Gd^Efm, Gd, Re, Gll^Fdw, Gll, Hh^Fdw, Gll, Gd^Efm, Hhd
Gll, Re^Es, Re, Re, Gd^Fdw, Gd^Fdw, Re^Efm, Gll, Gll^Es, Gll^Es, Md^Xm, Re, Gd^Fdw, Gd, Md, Hhd^Fp, Gd, Gll, Gll, Wog, Md^Xm, Hh^Em, Hh^Em, Hh, Gll, Gll, Gd, Re, Gll, Hh^Fdw, Md, Hhd^Emf, Gd^Efm, Hhd^Em
Hhd^Fdw, Gll, Gll, Md, Md, Md, Re, Gd^Vh, Re^Es, Md, Re, Md, Re, Md, Hhd^Feth, Md, Md, Gd^Fdw, Sm, Wwg^Wkf, Hh, Hh^Emf, Hhd^Em, Gd^Fdw, Hhd^Fp, Hhd^Fdw, Gd^Fdw, Re^Es, Re^Es, Hh, Md, Hhd^Emf, Gd^Em, Gd
Md, Md, Md, Hhd^Fp, Hhd^Fdw, Md, Re^Edb, Re^Edb, Gll, Gd^Fdw, Re, Re, Hhd^Fmw, Hhd^Fdw, Md^Xm, Md^Xm, Md, Hhd^Fdw, Hhd^Vhhr, Wwg^Wkf, Wwg^Wkf, Hhd^Em, Hhd^Emf, Hhd^Em, Hhd^Fp, Hhd, Hh, Gd, Re^Es, Md, Hh, Hhd^Em, Gll, Gd
Hhd, Md, Md, Md, Md, Hhd, Hhd, Gd, Gd, Gll, Re, Hhd, Md, Md, Md, Md, Hhd^Em, Gd^Fdw, Hhd^Fdw, Hhd, Wwg, Hhd^Em, Hh, Hhd^Emf, Gd, Hh, Hh, Gd^Ve, Re^Es, Md, Md, Hhd^Em, Md^Xm, Gd
Hhd, Hhd, Hhd^Fmw, Md, Hhd^Fdw, Hhd^Fp, Hhd, Gd^Fdw, Gd, Gll^Efm, Gd^Fdw, Re, Hhd^Fp, Md, Hhd^Em, Hhd^Emf, Gd^Efm, Rp, Hhd, Hhd, Hh, Wwg, Hhd^Fdw, Hhd^Emf, Gd^Em, Hh^Fp, Gd^Efm, Gd, Gd, Re, Re, Md, Md, Md
Md, Md^Xm, Md, Hhd^Fp, Md^Xm, Hhd^Fp, Hhd^Em, Re, Gd, Gll^Efm, Gll^Efm, Gd^Fdw, Gd^Fp, Gd^Fdw, Gll, Hhd^Em, Gd^Efm, Rp, Rp, Hhd^Fdw, Hhd, Wog, Hhd, Hhd, Gll, Gll, Gll, Gd^Efm, Md, Md, Hhd, Re, Re^Es, Md
Hhd, Md, Md, Md^Xm, Md, Md, Gd^Fp, Hhd^Emf, Hhd^Emf, Gd, Gd^Vh, Gll^Efm, Gll^Es, Hhd^Em, Hhd^Emf, Gll, Gd, Gll^Wm, Gll, Rp, Ds, Wog, Sm, Gll^Fdw, Wwg^Wkf, Wwrg, Wwrg, Hhd^Fdw, Cvr^Edb, Cvr^Edb, Cvr, Hhd^Es, Re^Es, Md
Hhd, Md, Md, Md, Hh, Gd^Fp, Re, Re^Em, Hhd^Em, Re, Re, Gd^Es, Gd, Hhd^Fdw, Gll, Gll^Em, Gd^Fdw, Gd, Gll^Efm, Gd, Ds, Wwf^Ewl, Wwg^Ewl, Wwg^Wkf, Wog, Wog, Wwrg, Rp, Cvr^Edb, 3 Kvr, Md, Hhd^Fp, Re, Md
Hhd, Hh, Md, Md, Hh^Fdw, Hhd, Hh, Hhd, Hhd^Fdw, Md, Rp, Re, Hh, Gll^Es, Gd, Hhd^Fdw, Hhd^Fmw, Gd^Fdw, Re, Gll^Edb, Ds, Wwf, Wwg^Ewf, Wog, Wog, Wwg, Gll, Rp, Rp^Edb, Cvr^Edb, Rp^Fdw, Md^Xm, Re, Md
Wog, Hhd^Fdw, Md, Hh^Fdw, Md^Xm, Hhd, Hhd, Hhd^Fdw, Hh, Hh^Fdw, Hh, Rp, Hh, Md, Md^Xm, Md, Hhd^Fp, Gd^Fp, Gd^Fp, Re, Ds, Wwf, Wwf^Wkf, Wog, Wwg^Ewl, Wwrg, Gll, Gd^Efm, Gd^Efm, Rp^Fdw, Re^Es, Re, Gll^Es, Gd
Wwg^Wkf, Wog, Wwrg, Md, Md, Md, Hhd^Fdw, Hhd, Hhd, Hh^Fdw, Rp, Rp, Hh, Md, Md, Md^Xm, Md, Hhd^Fdw, Hhd, Re, Re, Ds, Gll, Wwf^Wkf, Gll^Fdw, Wwrg, Wwrg, Gll, Re^Es, Re^Es, Gd, Gd^Ve, Md, Gll
Sm, Wwrg, Ds, Ds, Gll, Hh, Gll, Hh^Fdw, Hhd, Md, Re, Hhd^Feth, Hhd^Fdw, Hhd, Hhd, Md, Md, Md, Hhd, Hhd, Re, Hhd^Fdw, Gd, Gd, Gd, Gll, Ww^Bw/r, Re, Gd^Ve, Gd^Efm, Hh^Fdw, Hhd^Fdw, Md^Xm, Hhd^Fdw
Wwg, Wwg^Bw\, Ds, Gd, Gd, Gll^Es, Gd^Efm, Hhd, Re^Es, Re^Es, Hh^Emf, Hhd, Hhd^Fdw, Md, Md, Hhd, Hhd, Hhd^Fdw, Hhd^Fdw, Md, Hhd^Fdw, Md, Re, Gd^Ve, Re, Re, Wwg, Gll^Fdw, Re, Gd^Efm, Hh^Efm, Md, Md, Md
Wwg, Wog, Wwrg, Gd^Efm, Md, Gd, Gd^Edb, Gd^Vh, Re, Hh^Em, Hh^Fdw, Hh^Emf, Hhd, Hhd^Emf, Hhd^Em, Md, Gll^Edb, Md^Xm, Rp, Md, Md, Re, Hhd^Fdw, Md, Gll^Fdw, Gll, Wwrg, Gll^Fdw, Gll^Fdw, Re, Re^Es, Hh, Hhd^Fdw, Gd
Hh, Wwg^Wkf, Md, Md, Hhd, Hhd^Fdw, Gd^Edb, Re^Edb, Hh, Gd, Md, Hh^Es, Gd^Em, Gd^Em, Gd^Efm, Md, Rp, Gd^Edb, Rp^Edb, Hhd^Fdw, Md, Md, Gll^Edb, Gll, Re^Es, Gll^Fdw, Wwrg, Wwg, Wwf^Ewl, Ds, Ds, Re, Re, Re
Hhd, Hh^Em, Hh^Emf, Hhd^Em, Hh^Fdw, Hh^Fdw, Gd^Efm, Hh, Md^Xm, Md^Xm, Md, Gd, Md, Gd^Vh, Gll, Rp, Chr, Chr^Edb, Chr, Rp, Gll, Gll^Edb, Gd^Efm, Rb, Rb^Es, Gll^Es, Gll^Fp, Gll^Fetd, Wwf^Ewl, Wwg, Ww^Bw|r, Ds, Ds, Ds
Hh, Md, Md, Md, Gll, Gll^Es, Md, Md, Md, Md, Gll, Hhd^Fdw, Hhd^Em, Gll, Hh, Md, Chr^Edb, 4 Khr, Rr, Md, Gll^Efm, Gd, Gd, Md^Xm, Md^Xm, Rb^Es, Re^Efm, Gll^Efm, Ds, Wwf^Wkf, Ds, Wwg, Wwg^Wkf, Wwg^Wkf
Gll, Hh, Hhd^Vhhr, Gll^Efm, Hh, Hh^Fdw, Gd^Fdw, Md, Gd^Fdw, Gll, Gll^Efm, Hhd^Fdw, Gll^Efm, Gll, Re, Hhd, Md, Chr^Edb, Md, Md, Md, Gll^Efm, Gd^Vh, Gd, Gll^Es, Md, Md, Ds, Re, Ds, Gll^Fdw, Ds, Wwg^Ewl, Wog
Hh, Gll^Em, Gll, Gll^Efm, Re^Efm, Re^Es, Re, Gd^Fdw, Md^Xm, Gd, Gd, Gll^Efm, Gll, Hhd^Fp, Hhd^Emf, Re^Em, Hhd^Fdw, Hhd^Fdw, Hhd^Fdw, Md^Xm, Gll, Gll^Efm, Gd^Efm, Gll, Rb, Md, Rb^Efm, Hhd^Fdw, Hhd^Fdw, Re^Efm, Hhd^Fdw, Gll^Fdw, Wwg^Ewl, Wog^Wkf
Hh, Re, Re, Re, Hhd, Hhd, Hhd, Md, Md, Md, Md, Gd, Gd, Gd^Em, Gd, Hhd^Em, Gd, Hhd, Gd, Gll, Gd, Gd, Gd, Gll, Md, Rb, Md, Rb, Hhd^Fdw, Re, Re, Sm, Wwg, Wwg
