Xos, Xos, Xos, Xos, Xos, Xos, Xos, Xos, Xos, Xos, Xos, Xos, Xos, Xos, Xos, Xos, Xos, Xos, Xos, Xos, Xos^Efs, _off^_usr, Xos^Efs, Xos, Xos, Xos, Xos, Xos, Xos, Xos, Xos, Xos, Xos, Xos, Xos, Xos, Xos, Xos
Xos, Xos, Xos, Xos, Xos, Xos, Xos, Xos, Xos, Xos, Xos, Xos, Xos, Xos, Xos, Xos, Xos, Xos, Xos^Efs, Xos^Efs, Isa, Xos^Efs, Isa, Xos^Efs, Xos^Efs, Xos^Efs, Xos, Xos, Xos, Xos, Xos, Xos, Xos, Xos, Xos, Xos, Xos, Xos
Xos, Xos, Xos, Xos, Xos, Xos, Xos, Xos, Xos, Xos, Xos, Xos, Xos, Xos, Xos, Xos, Xos^Efs, Xos^Efs, Isa, Isa, Isa, Isa, Isa, Isa, Isa, Xos^Efs, Xos^Efs, Xos, Xos, Xos, Xos, Xos, Xos, Xos, Xos, Xos, Xos, Xos
Xos, Xos, Xos^Efs, Xos^Efs, Xos^Efs, Xos^Efs, Xos^Efs, Xos^Efs, Xos^Efs, Xos, Xos, Xos, Xos, Xos, Xos^Efs, Xos^Efs, Isa, Isa, Isa, Isa^Edt, Isa^Edt, Isa, Isa, Isa^Edt, Isa^Edt, Isa, Isa, Xos^Efs, Xos^Efs, Xos, Xos, Xos, Xos, Xos, Xos, Xos, Xos, Xos
Xos^Efs, Xos^Efs, Isa, Isa^Ii, Isa, Isa, Isa, Isa, Xos^Efs, Xos^Efs, Xos^Efs, Xos^Efs, Xos^Efs, Xos^Efs, Isa, Isa, Isa, Isa, Xos^Efs, Isa, Isa, Isa, Xos^Efs, Isa, Isa, Isa, Isa, Isa, Isa, Xos^Efs, Xos^Efs, Xos, Xos, Xos, Xos, Xos, Xos, Xos
Xos^Efs, Isa, Isa, Isa, Isa, Isa^Edt, Isa, Isa, Isa, Xos^Efs, Xos^Efs, Xos^Efs, Isa, Isa^Edt, Isa, Isa, Xos^Efs, Xos^Efs, Isa, Isa, Isa, Isa, Isa, Xos^Efs, Xos^Efs, Isa, Isa, Isa^Edt, Isa, Isa, Isa, Xos^Efs, Xos^Efs, Xos, Xos, Xos, Xos, Xos
Xos^Efs, Isa, Xos^Efs, Xos^Efs, Xos^Efs, Xos^Efs, Xos^Efs, Isa, Isa, Isa, Xos^Efs, Re, Isa, Isa^Edt, Xos^Efs, Xos^Efs, Isa, Isa, Isa, Isa, Xos^Efs, Isa, Isa^Edt, Isa, Isa, Xos^Efs, Xos^Efs, Isa, Isa, Isa, Re, Isa, Xos^Efs, Xos, Xos, Xos, Xos, Xos
Xos^Efs, Isa, Isa, Isa, Isa, Isa, Isa, Isa, Xos^Efs, Xos^Efs, Xos^Efs, Xos^Efs, Xos^Efs, Xos^Efs, Isa, Isa, Isa, Isa, Xos^Efs, Xos^Efs, Isa, Isa, Isa, Isa, Isa, Isa, Isa, Xos^Efs, Xos^Efs, Isa, Isa, Isa, Xos^Efs, Xos, Xos, Xos, Xos, Xos
Xos^Efs, Isa, Xos^Efs, Isa^Edt, Isa, Isa, Xos^Efs, Isa, Xos^Efs, Xos, Xos, Xos^Efs, Isa, Isa, Isa, Isa, Xos^Efs, Xos^Efs, Isa, Isa, Isa, Isa, Xos^Efs, Isa, Isa, Isa, Isa, Isa, Isa, Xos^Efs, Xos^Efs, Isa, Xos^Efs, Xos, Xos, Xos, Xos, Xos
Xos^Efs, Isa, Isa, Xos^Efs, Xos^Efs, Xos^Efs, Isa, Isa, Xos^Efs, Xos, Xos, Xos^Efs, Isa, Isa, Xos^Efs, Xos^Efs, Isa, Isa, Isa, Isa^Edt, Isa, Isa, Isa, Xos^Efs, Xos^Efs, Isa, Isa, Isa^Edt, Isa^Edt, Isa, Isa, Xos^Efs, Xos^Efs, Xos, Xos, Xos, Xos, Xos
Xos^Efs, Isa, Isa, Isa, Isa^Edt, Isa^Edt, Isa, Isa, Xos^Efs, Xos, Xos, Xos^Efs, Xos^Efs, Xos^Efs, Isa, Isa, Isa, Isa, Xos^Efs, Xos^Efs, Isa, Isa, Isa, Isa, Isa, Xos^Efs, Xos^Efs, Isa, Isa, Isa, Re, Isa, Xos^Efs, Xos, Xos, Xos, Xos, Xos
Xos^Efs, Isa, Xos^Efs, Isa, Isa, Isa, Xos^Efs, Xos^Efs, Xos^Efs, Xos, Xos, Xos^Efs, Isa, Isa, Isa, Isa, Xos^Efs, Xos^Efs, Isa, Isa, Isa, Isa, Xos^Efs, Isa, Isa, Isa, Isa, Xos^Efs, Xos^Efs, Isa, Isa, Isa, Xos^Efs, Xos, Xos, Xos, Xos, Xos
Xos, Xos^Efs, Xos, Xos^Efs, Xos^Efs, Xos^Efs, Xos, Xos, Xos, Xos, Xos, Xos^Efs, Isa, Isa, Xos^Efs, Xos^Efs, Isa, Isa, Isa, Isa, Xos^Efs, Xos^Efs, Isa, Isa, Isa, Isa, Isa, Isa, Isa^Edt, Xos^Efs, Xos^Efs, Isa, Xos^Efs, Xos, Xos, Xos, Xos, Xos
Xos, Xos, Xos, Xos, Xos, Xos, Xos, Xos, Xos, Xos, Xos, Xos^Efs, Xos^Efs, Xos^Efs, Isa, Isa^Edt, Isa, Isa, Xos^Efs, Xos^Efs, Isa, Isa, Isa^Edt, Isa, Xos^Efs, Xos^Efs, Isa, Isa^Edt, Isa, Isa^Edt, Isa, Xos^Efs, Xos^Efs, Xos, Xos, Xos, Xos, Xos
Xos, Xos, Xos, Xos, Xos, Xos, Xos, Xos, Xos, Xos, Xos, Xos^Efs, Isa, Isa, Isa, Isa, Xos^Efs, Xos^Efs, Isa, Isa, Isa, Isa, Xos^Efs, Xos^Efs, Isa, Isa, Isa, Isa, Xos^Efs, Isa, Isa, Isa, Xos^Efs, Xos, Xos, Xos, Xos, Xos
Xos, Xos, Xos, Xos, Xos, Xos, Xos, Xos, Xos, Xos, Xos, Xos^Efs, Xos^Efs, Isa^Edt, Xos^Efs, Xos^Efs, Isa, Isa, Isa, Isa, Xos^Efs, Xos^Efs, Isa^Edt, Isa, Isa, Isa, Xos^Efs, Xos^Efs, Isa, Isa, Isa, Isa, Xos^Efs, Xos, Xos, Xos, Xos, Xos
Xos, Xos, Xos, Xos, Xos, Xos, Xos, Xos, Xos, Xos, Xos, Xos, Xos, Xos^Efs, Xos^Efs, Isa, Isa, Isa, Xos^Efs, Xos^Efs, Isa, Isa, Isa, Isa, Xos^Efs, Xos^Efs, Isa, Isa, Isa, Isa, Xos^Efs, Xos^Efs, Xos, Xos, Xos, Xos, Xos, Xos
Xos, Xos, Xos, Xos, Xos, Xos, Xos, Xos, Xos, Xos, Xos, Xos, Xos, Xos, Xos, Xos^Efs, Xos^Efs, Isa, Xos^Efs, Isa, Xos^Efs, Isa, Isa, Xos^Efs, Isa, Isa, Isa, Isa, Xos^Efs, Xos^Efs, Xos, Xos, Xos, Xos, Xos, Xos, Xos, Xos
Xos, Xos, Xos, Xos, Xos, Xos, Xos, Xos, Xos, Xos, Xos, Xos, Xos, Xos, Xos, Xos, Xos^Efs, Xos^Efs, Isa, Xos^Efs, Isa, Xos^Efs, Re, Xos^Efs, Xos^Efs, Xos^Efs, Xos^Efs, Xos^Efs, Xos, Xos, Xos, Xos, Xos, Xos, Xos, Xos, Xos, Xos
Xos, Xos, Xos, Xos, Xos, Xos, Xos, Xos, Xos, Xos, Xos, Xos, Xos, Xos, Xos, Xos, Xos^Efs, Isa, Isa, Isa, Isa, Isa, Isa^Edt, Isa, Isa, Isa, Isa, Xos^Efs, Xos^Efs, Xos, Xos, Xos, Xos, Xos, Xos, Xos, Xos, Xos
Xos, Xos, Xos, Xos, Xos, Xos, Xos, Xos, Xos, Xos, Xos, Xos, Xos, Xos, Xos^Efs, Xos^Efs, Isa, Xos^Efs, Xos^Efs, Isa^Edt, Isa, Isa, Isa^Edt, Isa^Vhcr, Isa^Edt, Isa, Isa, Re, Isa, Xos^Efs, Xos^Efs, Xos, Xos, Xos, Xos, Xos, Xos, Xos
Xos, Xos, Xos, Xos, Xos, Xos, Xos, Xos, Xos, Xos, Xos, Xos, Xos^Efs, Xos^Efs, Isa, Xos^Efs, Isa, Isa, Isa, Re, Isa, Isa, Isa, Isa^Edt, Isa, Isa, Isa, Xos^Efs, Isa, Isa, Isa, Xos^Efs, Xos^Efs, Xos, Xos, Xos, Xos, Xos
Xos, Xos, Xos, Xos, Xos, Xos, Xos, Xos, Xos, Xos, Xos, Xos^Efs, Isa, Isa, Isa, Xos^Efs, Isa, Isa, Isa^Edt, Xos^Efs, Xos^Efs, Isa, Isa, Isa, Isa, Isa, Xos^Efs, Xos^Efs, Isa, Isa, Isa, Isa, Isa, Xos^Efs, Xos^Efs, Xos, Xos, Xos
Xos, Xos, Xos, Xos, Xos, Xos, Xos, Xos, Xos, Xos, Xos, Xos^Efs, Isa, Isa, Isa, Xos^Efs, Isa, Isa, Isa^Edt, Isa, Xos^Efs, Xos^Efs, Xos^Efs, Isa, Re, Xos^Efs, Xos^Efs, Xos^Efs, Isa, Isa, Isa^Edt, Isa, Isa, Isa^Edt, Xos^Efs, Xos, Xos, Xos
Xos, Xos, Xos, Xos, Xos, Xos, Xos, Xos, Xos, Xos, Xos, Xos^Efs, Isa, Isa, Xos^Efs, Re, Isa, Isa^Edt, Isa, Isa, Xos^Efs, Isa, Isa, Xos^Efs, Xos^Efs, Isa, Isa, Xos^Efs, Xos^Efs, Isa, Isa, Isa, Isa, Isa^Edt, Xos^Efs, Xos, Xos, Xos
Xos, Xos, Xos, Xos, Xos, Xos, Xos, Xos, Xos, Xos, Xos, Xos^Efs, Xos^Efs, Xos^Efs, Isa, Isa, Isa^Edt, Isa^Edt, Isa, Isa, Xos^Efs, Isa, Isa, Isa, Xos^Efs, Isa, Isa, Isa, Isa, Xos^Efs, Xos^Efs, Isa, Xos^Efs, Xos^Efs, Xos^Efs, Xos, Xos, Xos
Xos, Xos, Xos, Xos, Xos, Xos, Xos, Xos, Xos, Xos, Xos, Xos^Efs, Xos^Efs, Isa, Isa, Isa, Isa, Isa, Xos^Efs, Xos^Efs, Xos^Efs, Isa, Isa, Isa, Re, Isa, Isa^Edt, Isa, Isa, Isa, Xos^Efs, Re, Isa, Xos^Efs, Xos^Efs, Xos, Xos, Xos
Xos, Xos, Xos, Xos, Xos, Xos, Xos, Xos, Xos, Xos, Xos, Xos^Efs, Isa, Xos^Efs, Re, Isa, Xos^Efs, Xos^Efs, Isa, Isa, Xos^Efs, Isa, Isa, Isa, Xos^Efs, Isa, Isa, Isa, Xos^Efs, Xos^Efs, Isa, Isa, Isa, Isa, Xos^Efs, Xos, Xos, Xos
Xos, Xos, Xos, Xos, Xos, Xos, Xos, Xos, Xos, Xos, Xos, Xos^Efs, Isa, Isa, Isa, Xos^Efs, Isa, Isa, Isa, Isa, Xos^Efs, Isa, Isa, Isa, Xos^Efs, Isa, Re, Xos^Efs, Xos^Efs, Isa, Isa, Isa, Isa, Isa, Xos^Efs, Xos, Xos, Xos
Xos, Xos, Xos, Xos, Xos, Xos, Xos, Xos, Xos, Xos, Xos, Xos^Efs, Isa, Isa, Isa, Xos^Efs, Isa, Isa^Edt, Isa^Edt, Isa, Xos^Efs, Isa, Isa, Isa, Xos^Efs, Xos^Efs, Isa, Isa, Xos^Efs, Isa, Isa, Isa^Edt, Isa, Isa, Xos^Efs, Xos, Xos, Xos
Xos, Xos, Xos, Xos, Xos, Xos, Xos, Xos, Xos, Xos, Xos, Xos^Efs, Xos^Efs, Isa, Isa, Re, Isa, Isa, Isa, Isa, Xos^Efs, Isa, Isa, Isa, Xos^Efs, Isa, Isa, Isa, Xos^Efs, Isa, Isa, Isa, Isa, Isa, Xos^Efs, Xos, Xos, Xos
Xos, Xos, Xos, Xos, Xos, Xos, Xos, Xos, Xos, Xos, Xos, Xos, Xos, Xos^Efs, Xos^Efs, Xos^Efs, Isa, Isa, Isa, Isa, Xos^Efs, Isa, Xos^Efs, Xos^Efs, Xos^Efs, Isa, Isa, Isa, Xos^Efs, Isa, Isa^Edt, Isa, Xos^Efs, Xos^Efs, Xos, Xos, Xos, Xos
Xos, Xos, Xos, Xos, Xos, Xos, Xos, Xos, Xos, Xos, Xos, Xos, Xos, Xos, Xos, Xos^Efs, Xos^Efs, Isa, Isa, Isa, Re, Xos^Efs, Isa, Isa, Isa, Xos^Efs, Isa, Isa, Xos^Efs, Isa, Xos^Efs, Xos^Efs, Xos, Xos, Xos, Xos, Xos, Xos
Xos, Xos, Xos, Xos, Xos, Xos, Xos, Xos, Xos, Xos, Xos, Xos, Xos, Xos, Xos, Xos, Xos, Xos^Efs, Xos^Efs, Xos^Efs, Isa, Isa, Isa, Isa, Isa, Re, Xos^Efs, Isa, Xos^Efs, Xos^Efs, Xos, Xos, Xos, Xos, Xos, Xos, Xos, Xos
Xos, Xos, Xos, Xos, Xos, Xos, Xos, Xos, Xos, Xos, Xos, Xos, Xos, Xos, Xos, Xos, Xos, Xos, Xos^Efs, Xos^Efs, Xos^Efs, Isa, Isa, Isa, Isa, Xos^Efs, Xos^Efs, Xos^Efs, Xos, Xos, Xos, Xos, Xos, Xos, Xos, Xos, Xos, Xos
Xos, Xos, Xos, Xos, Xos, Xos, Xos, Xos, Xos, Xos, Xos, Xos, Xos, Xos, Xos, Xos, Xos^Efs, Xos^Efs, Isa, Isa, Isa, Re, Xos^Efs, Isa, Xos^Efs, Xos^Efs, Xos, Xos, Xos, Xos, Xos, Xos, Xos, Xos, Xos, Xos, Xos, Xos
Xos, Xos, Xos, Xos, Xos, Xos, Xos, Xos, Xos, Xos, Xos, Xos, Xos, Xos, Xos^Efs, Xos^Efs, Isa, Isa, Isa^Edt, Isa^Edt, Isa^Edt, Isa, Isa, Xos^Efs, Xos^Efs, Xos, Xos, Xos, Xos, Xos, Xos, Xos, Xos, Xos, Xos, Xos, Xos, Xos
Xos, Xos, Xos, Xos, Xos, Xos, Xos, Xos, Xos, Xos, Xos, Xos, Xos^Efs, Xos^Efs, Isa, Isa, Isa, Isa, Isa, Isa^Vhcr, Isa, Isa, Isa, Isa, Xos^Efs, Xos^Efs, Xos^Efs, Xos, Xos, Xos, Xos, Xos, Xos, Xos, Xos, Xos, Xos, Xos
Xos, Xos, Xos, Xos, Xos, Xos, Xos, Xos, Xos, Xos, Xos^Efs, Xos^Efs, Isa, Xos^Efs, Xos^Efs, Isa, Isa, Isa^Edt, Isa, Isa, Isa, Isa, Xos^Efs, Xos^Efs, Isa, Isa, Isa, Xos^Efs, Xos^Efs, Xos, Xos, Xos, Xos, Xos, Xos, Xos, Xos, Xos
Xos, Xos, Xos, Xos, Xos, Xos, Xos, Xos, Xos^Efs, Xos^Efs, Isa, Isa, Isa, Isa, Isa^Edt, Xos^Efs, Xos^Efs, Isa, Isa, Isa, Isa, Xos^Efs, Isa, Isa, Isa^Edt, Isa, Isa, Isa, Isa, Xos^Efs, Xos^Efs, Xos, Xos, Xos, Xos, Xos, Xos, Xos
Xos, Xos, Xos, Xos, Xos, Xos, Xos^Efs, Xos^Efs, Isa, Xos^Efs, Xos^Efs, Isa, Isa, Isa, Isa, Isa^Edt, Isa^Edt, Xos^Efs, Xos^Efs, Isa, Isa, Isa, Isa^Edt, Isa^Edt, Isa, Isa, Isa, Isa, Isa^Edt, Isa, Isa, Xos^Efs, Xos, Xos, Xos, Xos, Xos, Xos
Xos, Xos, Xos, Xos, Xos, Xos, Xos^Efs, Isa, Isa, Isa, Isa, Xos^Efs, Xos^Efs, Isa^Edt, Isa, Isa, Isa^Edt, Isa, Isa, Isa, Isa, Isa^Edt, Isa, Xos^Efs, Xos^Efs, Isa^Edt, Isa, Isa, Isa, Isa, Isa, Xos^Efs, Xos, Xos, Xos, Xos, Xos, Xos
Xos, Xos, Xos, Xos, Xos, Xos, Xos^Efs, Isa, Isa, Isa, Isa^Edt, Isa, Isa, Xos^Efs, Xos^Efs, Isa, Isa, Isa, Isa, Isa, Xos^Efs, Isa, Isa, Isa, Isa, Xos^Efs, Xos^Efs, Isa, Isa, Isa, Isa, Xos^Efs, Xos, Xos, Xos, Xos, Xos, Xos
Xos, Xos, Xos, Xos, Xos, Xos, Xos^Efs, Isa, Isa, Isa^Edt, Isa^Edt, Isa, Isa, Isa, Isa, Isa, Isa, Isa, Xos^Efs, Xos^Efs, Isa, Isa, Isa, Isa, Isa, Isa, Isa, Xos^Efs, Xos^Efs, Isa, Isa, Xos^Efs, Xos, Xos, Xos, Xos, Xos, Xos
Xos, Xos, Xos, Xos, Xos, Xos, Xos^Efs, Xos^Efs, Xos^Efs, Isa, Isa, Isa, Isa^Edt, Isa, Isa, Isa, Xos^Efs, Xos^Efs, Isa, Isa, Isa^Edt, Isa, Xos^Efs, Isa, Isa, Isa, Isa, Isa, Isa, Xos^Efs, Xos^Efs, Xos^Efs, Xos, Xos, Xos, Xos, Xos, Xos
Xos, Xos, Xos, Xos, Xos, Xos, Xos^Efs, Isa, Isa, Xos^Efs, Xos^Efs, Isa, Isa, Isa, Isa, Xos^Efs, Isa, Isa, Isa, Isa, Isa, Isa, Isa, Xos^Efs, Xos^Efs, Isa, Isa, Isa, Isa, Isa, Isa, Xos^Efs, Xos, Xos, Xos, Xos, Xos, Xos
Xos, Xos, Xos, Xos, Xos, Xos, Xos^Efs, Isa, Isa, Isa, Isa, Xos^Efs, Isa, Isa, Isa^Edt, Isa, Isa^Edt, Isa, Xos^Efs, Isa, Isa, Isa, Isa, Isa, Isa, Xos^Efs, Xos^Efs, Isa, Isa, Isa, Isa, Xos^Efs, Xos, Xos, Xos, Xos, Xos, Xos
Xos, Xos, Xos, Xos, Xos, Xos, Xos^Efs, Isa, Isa, Isa, Isa, Isa, Isa, Isa, Xos^Efs, Xos^Efs, Isa^Edt, Isa, Isa, Xos^Efs, Xos^Efs, Isa, Isa, Isa, Isa, Isa, Isa, Xos^Efs, Xos^Efs, Isa, Isa, Xos^Efs, Xos, Xos, Xos, Xos, Xos, Xos
Xos, Xos, Xos, Xos, Xos, Xos, Xos^Efs, Isa, Isa, Isa, Isa, Isa, Xos^Efs, Xos^Efs, Isa, Isa, Isa, Isa, Isa, Isa, Isa, Xos^Efs, Xos^Efs, Isa, Isa, Isa, Isa, Isa, Isa, Xos^Efs, Isa, Xos^Efs, Xos, Xos, Xos, Xos, Xos, Xos
Xos, Xos, Xos, Xos, Xos, Xos, Xos, Xos^Efs, Xos^Efs, Isa, Xos^Efs, Xos^Efs, Isa, Isa, Isa, Isa, Xos^Efs, Isa, Isa, Isa, Isa, Isa, Isa, Xos^Efs, Xos^Efs, Isa, Xos^Efs, Isa, Isa, Xos^Efs, Xos^Efs, Xos^Efs, Xos, Xos, Xos, Xos, Xos, Xos
Xos, Xos, Xos, Xos, Xos, Xos, Xos, Xos, Xos, Xos^Efs, Xos^Efs, Isa, Isa, Isa, Isa^Edt, Isa, Isa^Edt, Xos^Efs, Xos^Efs, Isa, Isa, Isa, Isa^Edt, Isa^Edt, Isa^Edt, Xos^Efs, Isa, Xos^Efs, Xos^Efs, Xos^Efs, Xos, Xos, Xos, Xos, Xos, Xos, Xos, Xos
Xos, Xos, Xos, Xos, Xos, Xos, Xos, Xos, Xos, Xos, Xos, Xos^Efs, Xos^Efs, Isa^Edt, Isa, Isa^Edt, Isa, Isa^Edt, Isa, Xos^Efs, Xos^Efs, Isa, Isa, Isa, Isa, Isa, Xos^Efs, Xos^Efs, Xos, Xos, Xos, Xos, Xos, Xos, Xos, Xos, Xos, Xos
Xos, Xos, Xos, Xos, Xos, Xos, Xos, Xos, Xos, Xos, Xos, Xos, Xos, Xos^Efs, Xos^Efs, Isa, Isa^Edt, Isa, 1 Isa, Isa, Isa, Xos^Efs, Xos^Efs, Isa, Xos^Efs, Xos^Efs, Xos, Xos, Xos, Xos, Xos, Xos, Xos, Xos, Xos, Xos, Xos, Xos
Xos, Xos, Xos, Xos, Xos, Xos, Xos, Xos, Xos, Xos, Xos, Xos, Xos, Xos, Xos, Xos^Efs, Xos^Efs, Isa, Isa, Isa, Isa, Isa, Xos^Efs, Xos^Efs, Xos, Xos, Xos, Xos, Xos, Xos, Xos, Xos, Xos, Xos, Xos, Xos, Xos, Xos
Xos, Xos, Xos, Xos, Xos, Xos, Xos, Xos, Xos, Xos, Xos, Xos, Xos, Xos, Xos, Xos, Xos, Xos^Efs, Xos^Efs, Isa, Xos^Efs, Xos^Efs, Xos, Xos, Xos, Xos, Xos, Xos, Xos, Xos, Xos, Xos, Xos, Xos, Xos, Xos, Xos, Xos
Xos, Xos, Xos, Xos, Xos, Xos, Xos, Xos, Xos, Xos, Xos, Xos, Xos, Xos, Xos, Xos, Xos, Xos, Xos^Efs, Re, Xos^Efs, Xos, Xos, Xos, Xos, Xos, Xos, Xos, Xos, Xos, Xos, Xos, Xos, Xos, Xos, Xos, Xos, Xos
