Xos, Xos, Xos, Xos, Xos, Xos, Xos, Xos, Xos, Xos, Xos, Xos, Xos, Xos, Xos, Xos, Xos, Xos, Xos, Xos, Xos, Xos, Xos, Xos, Xos, Xos, Xos, Xos, Xos, Xos, Xos, Xos
Xos, Xos, Xos, Xos, Xos, Xos, Xos, Xos, Xos, Xos, Xos, Xos, Xos, Xos, Xos, Xos, Xos, Xos, Xos, Xos, Xos, Xos, Xos, Xos, Xos, Xos, Xos, Xos, Xos, Xos, Xos, Xos
Xos, Xos, Xos, Xos, Xos, Xos, Xos^Efs, Xos^Efs, Xos^Efs, Xos, Xos, Xos, Xos, Xos, Xos, Xos, Xos, Xos, Xos, Xos, Xos, Xos, Xos, Xos, Xos, Xos, Xos^Efs, Xos, Xos^Efs, Xos, Xos, Xos
Xos, Xos, Xos, Xos, Xos, Xos, Iwo, Iwc, Iwc, Xos, Xos, Xos, Xos, Xos, Xos, Xos, Xos, Xos, Xos, Xos, Xos, Xos, Xos, Xos, Xos, Xos^Efs, Iwo, Iwc, Iwc, Xos^Efs, Xos, Xos
Xos, Xos, Xos, Xos, Xos, Iwo, Iwo^Ebn, Iwo, Iwo, Iwc, Xos, Xos, Xos, Xos, Xos, Xos, Xos, Xos, Xos, Xos, Xos, Xos, Xos, Xos, Iwo, Iwo, Iwo, Iwo, Iwo^Ii, Iwc, Xos, Xos
Xos, Xos, Xos, Xos, Xos, Iwo, Iwo^Eb, Iwo, Iwo, Iwc, Xos, Xos, Xos, Xos, Xos, Xos, Xos, Xos, Xos, Xos, Xos^Efs, Xos^Efs, Iwo, Xos^Efs, Xos^Efs, Iwo, Iwo, Iwo, Iwo, Iwc, Xos, Xos
Xos, Xos, Xos, Xos, Xos, Iwo, Iwo, Iwo, Iwo, Iwc, Xos, Xos, Xos, Xos, Xos, Xos, Xos, Xos, Xos, Xos, Iwo, Iwo, Ch, Iwo, Iwo, Xos, Iwo, Iwo, Iwo^Eb, Iwc, Xos, Xos
Xos, Xos, Xos, Xos, Xos^Efs, Xos, Xos, Iwo, Iwo, Iwo, Iwo, Xos^Efs, Xos, Xos, Xos, Xos, Xos, Xos, Xos, Iwo, Iwo^Ebn, Iwo, Ch, 2 Kh, Iwo, Xos, Iwo, Iwo^Eb, Iwc, Iwc, Xos, Xos
Xos, Xos, Xos, Xos^Efs, Iwc, Xos^Efs, Xos, Xos, Xos, Iwo, Iwo, Iwo, Iwo, Xos, Xos, Xos, Xos, Xos, Xos, Iwo, Iwo, Iwo, Iwo, Ch, Iwo, Xos, Iwc, Iwc, Xos, Xos, Xos, Xos
Xos, Xos, Iwc, Iwc, Iwo, Iwo, Iwo, Xos, Iwo, Iwo, Iwo, Iwo, Xos^Efs, Xos^Efs, Iwc, Xos, Xos, Xos, Xos, Iwo, Iwo, Iwo^Vhc, Iwo, Iwo, Iwo, Xos, Xos, Xos, Xos, Xos, Xos, Xos
Xos, Xos, Iwc, Iwo, Iwo, Iwo, Iwo, Iwo, Iwo^Vhc, Iwo, Iwo, Xos, Iwo, Iwo, Iwc, Xos, Xos, Xos, Xos^Efs, Iwo, Iwo, Iwo, Iwo, Iwo, Xos, Xos, Xos, Xos, Xos, Xos, Xos, Xos
Xos, Xos, Iwc, Iwo^Eb, Iwo, Iwo, Iwo, Iwo, Iwo, Iwo, Iwo, Iwo, Iwo, Iwo, Xos, Xos, Xos^Efs, Xos, Iwo, Iwo, Iwo, Iwo, Xos, Xos, Xos, Xos, Xos, Xos, Xos, Xos, Xos, Xos
Xos, Xos, Xos, Iwc, Iwc, Iwo, Xos, Xos, Iwo, Iwo, Iwo, Iwo, Iwo, Xos, Xos, Xos^Efs, Iwo, Iwo, Iwo, Iwo, Xos, Xos, Xos, Xos, Xos, Xos, Xos, Xos, Xos, Xos, Xos, Xos
Xos, Xos, Xos, Xos, Xos, Xos, Xos, Xos, Iwo, Iwo, Iwo, Iwo, Iwo, Iwo, Iwo, Iwo, Iwo, Iwo, Xos, Xos, Xos, Xos, Xos, Xos, Xos, Xos, Xos, Xos, Xos, Xos, Xos, Xos
Xos, Xos, Xos, Xos, Xos, Xos, Xos, Xos, Iwo, Iwo^Ebn, Iwo, Iwo, Iwo, Iwo, Iwo, Iwo, Xos, Xos, Xos, Xos, Xos, Xos, Xos, Xos, Xos, Xos, Xos, Xos, Xos, Xos, Xos, Xos
Xos, Xos, Xos, Xos, Xos, Xos, Xos, Xos, Xos, Iwo, Iwo, Iwo, Iwo, Iwo, Xos, Xos, Xos, Xos, Xos, Xos, Xos, Xos, Xos, Xos, Xos, Xos, Xos, Xos, Xos, Xos, Xos, Xos
Xos, Xos, Xos, Xos, Xos, Xos, Xos, Xos, Xos, Xos, Iwo, Iwo, Iwo, Xos, Xos, Xos, Xos, Xos, Xos, Xos, Xos, Xos, Xos, Xos, Xos, Xos, Xos, Xos, Xos, Xos, Xos, Xos
Xos, Xos, Xos, Xos, Xos, Xos, Xos, Xos, Xos, Xos, Iwo, Iwo, Iwo, Xos, Xos, Xos, Xos, Xos, Xos^Efs, Xos, Xos^Efs, Xos, Xos, Xos, Xos, Xos, Xos, Xos, Xos, Xos, Xos, Xos
Xos, Xos, Xos, Xos, Xos, Xos, Xos, Xos, Xos, Xos, Iwo, Iwo, Iwo, Xos, Xos, Xos, Xos, Xos^Efs, Iwo, Iwc, Iwc, Xos, Xos, Xos, Xos, Xos, Xos, Xos, Xos, Xos, Xos, Xos
Xos, Xos, Xos, Xos, Xos, Xos, Xos, Xos, Xos^Efs, Xos^Efs, Iwo, Iwo^Vhc, Iwo, Xos, Xos^Efs, Xos, Xos^Efs, Iwo, Iwo, Iwo^Eb, Iwc, Xos, Xos, Xos, Xos, Xos, Xos, Xos, Xos, Xos, Xos, Xos
Xos, Xos, Xos, Xos, Xos, Xos, Xos, Xos, Iwo, Iwo, Iwo, Iwo, Iwo, Iwo, Iwo, Xos^Efs, Iwo, Iwo, Iwo, Iwo, Iwc, Xos, Xos, Xos, Xos, Xos, Xos, Xos, Xos, Xos, Xos, Xos
Xos, Xos, Xos, Xos, Xos, Xos, Xos, Iwo, Iwo, Iwo, Xos, Xos, Xos, Iwo, Iwo, Iwo, Iwo, Iwo, Iwc, Iwc, Xos, Xos, Xos, Xos, Xos, Xos, Xos, Xos, Xos, Xos, Xos, Xos
Xos, Xos, Xos, Xos, Xos, Xos, Xos, Iwo, Iwo, Xos, Xos, Xos, Xos, Xos, Iwo, Iwo, Xos, Xos, Xos, Xos, Xos, Xos, Xos, Xos, Xos, Xos, Xos, Xos, Xos, Xos, Xos, Xos
Xos, Xos, Xos, Xos, Xos, Xos, Xos, Iwo, Iwo, Xos, Xos^Efs, Xos, Xos, Xos, Iwo, Iwo, Xos, Xos, Xos^Efs, Xos, Iwc, Xos^Efs, Xos^Efs, Xos, Xos, Xos, Xos, Xos, Xos, Xos, Xos, Xos
Xos, Xos, Xos, Xos, Xos, Xos, Xos, Iwo, Iwo, Iwo, Iwo, Xos^Efs, Xos, Xos, Iwo, Iwo, Xos, Xos, Iwo, Iwo, Iwo, Iwc, Iwc, Xos, Xos, Xos, Xos, Xos, Xos, Xos, Xos, Xos
Xos, Xos, Xos, Xos, Xos, Xos, Xos^Efs, Xos, Iwo, Iwo, Iwo, Iwo, Iwo, Xos^Efs, Iwo, Iwo, Xos, Iwo, Iwo, Iwo, Iwo, Iwo, Iwo^Ebn, Iwc, Xos, Xos, Xos, Xos, Xos, Xos, Xos, Xos
Xos, Xos, Xos, Xos, Xos, Xos, Iwo, Iwo, Iwo, Iwo, Xos, Iwo, Iwo, Iwo, Iwo^Vhc, Iwo, Iwo, Iwo, Iwo, Xos, Xos^Efs, Iwo, Iwc, Iwc, Xos, Xos, Xos, Xos, Xos, Xos, Xos, Xos
Xos, Xos, Xos, Xos, Xos, Xos, Iwo, Iwo, Iwo, Iwc, Xos, Xos, Xos, Iwo, Iwo, Iwo, Iwo, Iwo, Iwo, Iwo, Iwo, Xos^Efs, Xos, Xos, Xos, Xos, Xos, Xos, Xos, Xos, Xos, Xos
Xos, Xos, Xos, Xos, Xos, Xos, Iwo, Iwo, Iwo^Eb, Iwc, Xos, Xos, Xos^Efs, Xos, Xos, Iwo, Iwo, Iwo, Iwo, Iwo, Iwo, Iwo, Iwo, Xos^Efs, Xos, Xos, Xos, Xos, Xos, Xos, Xos, Xos
Xos, Xos, Xos, Xos, Xos, Xos, Xos, Iwo, Iwc, Iwc, Xos, Xos, Iwc, Xos, Xos^Efs, Xos, Xos, Iwo, Iwo, Iwo, Iwo, Iwo, Iwo^Eb, Iwo, Xos, Xos, Xos, Xos, Xos, Xos, Xos, Xos
Xos, Xos, Xos, Xos, Xos, Xos, Xos, Xos, Xos, Xos, Xos, Iwc, Iwo, Iwo, Iwo, Xos^Efs, Xos, Iwo, Iwo, Iwo, Iwo, Iwo, Iwo, Iwo, Xos, Xos, Xos, Xos, Xos, Xos, Xos, Xos
Xos, Xos, Xos, Xos, Xos, Xos, Xos, Xos, Xos, Xos, Xos, Iwc, Iwo, Iwo, Iwo, Iwo, Iwo, Iwo, Iwo, Iwo, Iwo, Iwo, Iwo, Iwo, Iwo, Xos^Efs, Xos^Efs, Xos, Xos, Xos, Xos, Xos
Xos, Xos, Xos, Xos, Xos, Xos, Xos, Xos, Xos, Xos, Xos, Iwc, Iwc, Iwo, Iwo, Iwo^Eb, Iwo, Iwo, Xos, Iwo, Iwc, Iwo, Xos, Iwo, Iwo, Iwo, Iwo, Xos, Xos, Xos, Xos, Xos
Xos, Xos, Xos, Xos, Xos, Xos, Xos, Xos, Xos, Xos, Xos, Xos, Xos, Iwc, Iwc, Iwo, Xos, Xos, Xos, Xos, Xos, Xos, Xos, Xos, Xos, 1 Iwo, Iwo, Iwo, Xos, Xos, Xos, Xos
Xos, Xos, Xos, Xos, Xos, Xos, Xos, Xos, Xos, Xos, Xos, Xos, Xos, Xos, Xos, Xos, Xos, Xos, Xos, Xos, Xos, Xos, Xos, Xos, Xos, Xos, Xos, Iwo, Xos, Xos, Xos, Xos
Xos, Xos, Xos, Xos, Xos, Xos, Xos, Xos, Xos, Xos, Xos, Xos, Xos, Xos, Xos, Xos, Xos, Xos, Xos, Xos, Xos, Xos, Xos, Xos, Xos, Xos, Xos, Iwo, Xos, Xos, Xos, Xos
