Xos, Xos, Xos, Xos, Xos, Xos, Xos, Xos, Xos, Xos, Xos, Xos, Xos, Xos, Xos, Xos, Xos, Xos, Xos, Xos, Xos^Efs, Xos, Xos^Efs, Xos, Xos, Xos, Xos, Xos, Xos, Xos, Xos, Xos, Xos, Xos, Xos, Xos
Xos, Xos, Xos, Xos, Xos, Xos, Xos, Xos, Xos, Xos, Xos, Xos, Xos, Xos, Xos, Xos, Xos, Xos, Xos^Efs, Xos^Efs, Isa, Xos^Efs, Isa, Xos^Efs, Xos^Efs, Xos^Efs, Xos, Xos, Xos, Xos, Xos, Xos, Xos, Xos, Xos, Xos
Xos, Xos, Xos, Xos, Xos, Xos, Xos, Xos, Xos, Xos, Xos, Xos, Xos, Xos, Xos, Xos, Xos^Efs, Xos^Efs, Isa, Isa, Isa, Isa, Isa, Isa, Isa, Xos^Efs, Xos^Efs, Xos, Xos, Xos, Xos, Xos, Xos, Xos, Xos, Xos
Xos, Xos, Xos^Efs, Xos^Efs, Xos^Efs, Xos^Efs, Xos^Efs, Xos^Efs, Xos^Efs, Xos, Xos, Xos, Xos, Xos, Xos^Efs, Xos^Efs, Isa, Isa, Isa, Isa, Isa, Isa, Isa, Isa, Isa, Isa, Isa, Xos^Efs, Xos^Efs, Xos, Xos, Xos, Xos, Xos, Xos, Xos
Xos^Efs, Xos^Efs, Isa, Isa, Isa, Isa, Isa, Isa, Xos^Efs, Xos^Efs, Xos^Efs, Xos^Efs, Xos^Efs, Xos^Efs, Isa, Isa, Isa, Isa, Xos^Efs, Isa, Isa, Isa, Xos^Efs, Isa, Isa, Isa, Isa, Isa, Isa, Xos^Efs, Xos^Efs, Xos, Xos, Xos, Xos, Xos
Xos^Efs, Isa, Isa, Isa, Isa, Isa, Isa, Isa, Isa, Xos^Efs, Xos^Efs, Xos^Efs, Isa, Isa, Isa, Isa, Xos^Efs, Xos^Efs, Isa, Isa, Isa, Isa, Isa, Xos^Efs, Xos^Efs, Isa, Isa, Isa, Isa, Isa, Isa, Xos^Efs, Xos^Efs, Xos, Xos, Xos
Xos^Efs, Isa, Xos^Efs, Xos^Efs, Xos^Efs, Xos^Efs, Xos^Efs, Isa, Isa, Rr, Xos^Efs, Rr, Isa, Isa, Xos^Efs, Xos^Efs, Isa, Isa, Isa, Isa, Xos^Efs, Isa, Isa, Isa, Isa, Xos^Efs, Xos^Efs, Isa, Isa, Isa, Isa, Isa, Xos^Efs, Xos, Xos, Xos
Xos^Efs, Isa, Isa, Isa, Isa, Isa, Isa, Isa, Xos^Efs, Xos^Efs, Xos^Efs, Xos^Efs, Xos^Efs, Xos^Efs, Isa, Isa, Isa, Isa, Xos^Efs, Xos^Efs, Isa, Isa, Isa, Isa, Isa, Isa, Isa, Xos^Efs, Xos^Efs, Isa, Isa, Isa, Xos^Efs, Xos, Xos, Xos
Xos^Efs, Isa, Xos^Efs, Isa, Isa, Isa, Xos^Efs, Isa, Xos^Efs, Xos, Xos, Xos^Efs, Isa, Isa, Isa, Isa, Xos^Efs, Xos^Efs, Isa, Isa, Isa, Isa, Xos^Efs, Isa, Isa, Isa, Isa, Isa, Isa, Xos^Efs, Xos^Efs, Isa, Xos^Efs, Xos, Xos, Xos
Xos^Efs, Isa, Isa, Xos^Efs, Xos^Efs, Xos^Efs, Isa, Isa, Xos^Efs, Xos, Xos, Xos^Efs, Isa, Isa, Xos^Efs, Xos^Efs, Isa, Isa, Isa, Isa, Isa, Isa, Isa, Xos^Efs, Xos^Efs, Isa, Isa, Isa, Isa, Isa, Isa, Xos^Efs, Xos^Efs, Xos, Xos, Xos
Xos^Efs, Isa, Isa, Isa, Isa, Isa, Isa, Isa, Xos^Efs, Xos, Xos, Xos^Efs, Xos^Efs, Xos^Efs, Isa, Isa, Isa, Isa, Xos^Efs, Xos^Efs, Isa, Isa, Isa, Isa, Isa, Xos^Efs, Xos^Efs, Isa, Isa, Isa, Isa, Isa, Xos^Efs, Xos, Xos, Xos
Xos^Efs, Isa, Xos^Efs, Isa, Isa, Isa, Xos^Efs, Xos^Efs, Xos^Efs, Xos, Xos, Xos^Efs, Isa, Isa, Isa, Isa, Xos^Efs, Xos^Efs, Isa, Isa, Isa, Isa, Xos^Efs, Isa, Isa, Isa, Isa, Xos^Efs, Xos^Efs, Isa, Isa, Isa, Xos^Efs, Xos, Xos, Xos
Xos, Xos^Efs, Xos, Xos^Efs, Xos^Efs, Xos^Efs, Xos, Xos, Xos, Xos, Xos, Xos^Efs, Isa, Isa, Xos^Efs, Xos^Efs, Isa, Isa, Isa, Isa, Xos^Efs, Xos^Efs, Isa, Isa, Isa, Isa, Isa, Isa, Isa, Xos^Efs, Xos^Efs, Isa, Xos^Efs, Xos, Xos, Xos
Xos, Xos, Xos, Xos, Xos, Xos, Xos, Xos, Xos, Xos, Xos, Xos^Efs, Xos^Efs, Xos^Efs, Isa, Isa, Isa, Isa, Xos^Efs, Xos^Efs, Isa, Isa, Isa, Isa, Xos^Efs, Xos^Efs, Isa, Isa, Isa, Isa, Isa, Xos^Efs, Xos^Efs, Xos, Xos, Xos
Xos, Xos, Xos, Xos, Xos, Xos, Xos, Xos, Xos, Xos, Xos, Xos^Efs, Isa, Isa, Isa, Isa, Xos^Efs, Xos^Efs, Isa, Isa, Isa, Isa, Xos^Efs, Xos^Efs, Isa, Isa, Isa, Isa, Xos^Efs, Isa, Isa, Isa, Xos^Efs, Xos, Xos, Xos
Xos, Xos, Xos, Xos, Xos, Xos, Xos, Xos, Xos, Xos, Xos, Xos^Efs, Xos^Efs, Isa, Xos^Efs, Xos^Efs, Isa, Isa, Isa, Isa, Xos^Efs, Xos^Efs, Isa, Isa, Isa, Isa, Xos^Efs, Xos^Efs, Isa, Isa, Isa, Isa, Xos^Efs, Xos, Xos, Xos
Xos, Xos, Xos, Xos, Xos, Xos, Xos, Xos, Xos, Xos, Xos, Xos, Xos, Xos^Efs, Xos^Efs, Isa, Isa, Isa, Xos^Efs, Xos^Efs, Isa, Isa, Isa, Isa, Xos^Efs, Xos^Efs, Isa, Isa, Isa, Isa, Xos^Efs, Xos^Efs, Xos, Xos, Xos, Xos
Xos, Xos, Xos, Xos, Xos, Xos, Xos, Xos, Xos, Xos, Xos, Xos, Xos, Xos, Xos, Xos^Efs, Xos^Efs, Isa, Xos^Efs, Isa, Xos^Efs, Isa, Isa, Xos^Efs, Isa, Isa, Isa, Isa, Xos^Efs, Xos^Efs, Xos, Xos, Xos, Xos, Xos, Xos
Xos, Xos, Xos, Xos, Xos, Xos, Xos, Xos, Xos, Xos, Xos, Xos, Xos, Xos, Xos, Xos, Xos^Efs, Xos^Efs, Isa, Xos^Efs, Isa, Xos^Efs, Rr, Xos^Efs, Xos^Efs, Xos^Efs, Xos^Efs, Xos^Efs, Xos, Xos, Xos, Xos, Xos, Xos, Xos, Xos
Xos, Xos, Xos, Xos, Xos, Xos, Xos, Xos, Xos, Xos, Xos, Xos, Xos, Xos, Xos, Xos, Xos^Efs, Isa, Isa, Isa, Isa, Isa, Isa, Isa, Isa, Isa, Isa, Xos^Efs, Xos^Efs, Xos, Xos, Xos, Xos, Xos, Xos, Xos
Xos, Xos, Xos, Xos, Xos, Xos, Xos, Xos, Xos, Xos, Xos, Xos, Xos, Xos, Xos^Efs, Xos^Efs, Isa, Xos^Efs, Xos^Efs, Isa, Isa, Isa, Isa, Isa, Isa, Isa, Isa, Rr, Isa, Xos^Efs, Xos^Efs, Xos, Xos, Xos, Xos, Xos
Xos, Xos, Xos, Xos, Xos, Xos, Xos, Xos, Xos, Xos, Xos, Xos, Xos^Efs, Xos^Efs, Isa, Xos^Efs, Isa, Isa, Isa, Rr, Isa, Isa, Isa, Isa, Isa, Isa, Isa, Xos^Efs, Isa, Isa, Isa, Xos^Efs, Xos^Efs, Xos, Xos, Xos
Xos, Xos, Xos, Xos, Xos, Xos, Xos, Xos, Xos, Xos, Xos, Xos^Efs, Isa, Isa, Isa, Xos^Efs, Isa, Isa, Isa, Xos^Efs, Xos^Efs, Isa, Isa, Isa, Isa, Isa, Xos^Efs, Xos^Efs, Isa, Isa, Isa, Isa, Isa, Xos^Efs, Xos^Efs, Xos
Xos, Xos, Xos, Xos, Xos, Xos, Xos, Xos, Xos, Xos, Xos, Xos^Efs, Isa, Isa, Isa, Xos^Efs, Isa, Isa, Isa, Isa, Xos^Efs, Xos^Efs, Xos^Efs, Isa, Rr, Xos^Efs, Xos^Efs, Xos^Efs, Isa, Isa, Isa, Isa, Isa, Isa, Xos^Efs, Xos
Xos, Xos, Xos, Xos, Xos, Xos, Xos, Xos, Xos, Xos, Xos, Xos^Efs, Isa, Isa, Xos^Efs, Rr, Isa, Isa, Isa, Isa, Xos^Efs, Isa, Isa, Xos^Efs, Xos^Efs, Isa, Isa, Xos^Efs, Xos^Efs, Isa, Isa, Isa, Isa, Isa, Xos^Efs, Xos
Xos, Xos, Xos, Xos, Xos, Xos, Xos, Xos, Xos, Xos, Xos, Xos^Efs, Xos^Efs, Xos^Efs, Isa, Isa, Isa, Isa, Isa, Isa, Xos^Efs, Isa, Isa, Isa, Xos^Efs, Isa, Isa, Isa, Isa, Xos^Efs, Xos^Efs, Isa, Xos^Efs, Xos^Efs, Xos^Efs, Xos
Xos, Xos, Xos, Xos, Xos, Xos, Xos, Xos, Xos, Xos, Xos, Xos^Efs, Xos^Efs, Isa, Isa, Isa, Isa, Isa, Xos^Efs, Xos^Efs, Xos^Efs, Isa, Isa, Isa, Rr, Isa, Isa, Isa, Isa, Isa, Xos^Efs, Rr, Isa, Xos^Efs, Xos^Efs, Xos
Xos, Xos, Xos, Xos, Xos, Xos, Xos, Xos, Xos, Xos, Xos, Xos^Efs, Isa, Xos^Efs, Rr, Isa, Xos^Efs, Xos^Efs, Isa, Isa, Xos^Efs, Isa, Isa, Isa, Xos^Efs, Isa, Isa, Isa, Xos^Efs, Xos^Efs, Isa, Isa, Isa, Isa, Xos^Efs, Xos
Xos, Xos, Xos, Xos, Xos, Xos, Xos, Xos, Xos, Xos, Xos, Xos^Efs, Isa, Isa, Isa, Xos^Efs, Isa, Isa, Isa, Isa, Xos^Efs, Isa, Isa, Isa, Xos^Efs, Isa, Rr, Xos^Efs, Xos^Efs, Isa, Isa, Isa, Isa, Isa, Xos^Efs, Xos
Xos, Xos, Xos, Xos, Xos, Xos, Xos, Xos, Xos, Xos, Xos, Xos^Efs, Isa, Isa^Vhcr, Isa, Xos^Efs, Isa, Isa, Isa, Isa, Xos^Efs, Isa, Isa, Isa, Xos^Efs, Xos^Efs, Isa, Isa, Xos^Efs, Isa, Isa, Isa, Isa, Isa, Xos^Efs, Xos
Xos, Xos, Xos, Xos, Xos, Xos, Xos, Xos, Xos, Xos, Xos, Xos^Efs, Xos^Efs, Isa, Isa, Rr, Isa, Isa, Isa, Isa, Xos^Efs, Isa, Isa, Isa, Xos^Efs, Isa, Isa^Vhcr, Isa, Xos^Efs, Isa, Isa, Isa, Isa, Isa, Xos^Efs, Xos
Xos, Xos, Xos, Xos, Xos, Xos, Xos, Xos, Xos, Xos, Xos, Xos, Xos, Xos^Efs, Xos^Efs, Xos^Efs, Isa, Isa, Isa, Isa, Xos^Efs, Isa, Xos^Efs, Xos^Efs, Xos^Efs, Isa, Isa, Isa, Xos^Efs, Isa, Isa, Isa, Xos^Efs, Xos^Efs, Xos, Xos
Xos, Xos, Xos, Xos, Xos, Xos, Xos, Xos, Xos, Xos, Xos, Xos, Xos, Xos, Xos, Xos^Efs, Xos^Efs, Isa, Isa, Isa, Rr, Xos^Efs, Isa, Isa, Isa, Xos^Efs, Isa, Isa, Xos^Efs, Isa, Xos^Efs, Xos^Efs, Xos, Xos, Xos, Xos
Xos, Xos, Xos, Xos, Xos, Xos, Xos, Xos, Xos, Xos, Xos, Xos, Xos, Xos, Xos, Xos, Xos, Xos^Efs, Xos^Efs, Xos^Efs, Isa, Isa, Isa, Isa, Isa, Rr, Xos^Efs, Isa, Xos^Efs, Xos^Efs, Xos, Xos, Xos, Xos, Xos, Xos
Xos, Xos, Xos, Xos, Xos, Xos, Xos, Xos, Xos, Xos, Xos, Xos, Xos, Xos, Xos, Xos, Xos, Xos, Xos^Efs, Xos^Efs, Xos^Efs, Isa, Isa, Isa^Vhcr, Isa, Xos^Efs, Xos^Efs, Xos^Efs, Xos, Xos, Xos, Xos, Xos, Xos, Xos, Xos
Xos, Xos, Xos, Xos, Xos, Xos, Xos, Xos, Xos, Xos, Xos, Xos, Xos, Xos, Xos, Xos, Xos^Efs, Xos^Efs, Isa, Isa, Isa, Rr, Xos^Efs, Isa, Xos^Efs, Xos^Efs, Xos, Xos, Xos, Xos, Xos, Xos, Xos, Xos, Xos, Xos
Xos, Xos, Xos, Xos, Xos, Xos, Xos, Xos, Xos, Xos, Xos, Xos, Xos, Xos, Xos^Efs, Xos^Efs, Isa, Isa, Isa, Isa, Isa, Isa, Isa, Xos^Efs, Xos^Efs, Xos, Xos, Xos, Xos, Xos, Xos, Xos, Xos, Xos, Xos, Xos
Xos, Xos, Xos, Xos, Xos, Xos, Xos, Xos, Xos, Xos, Xos, Xos, Xos^Efs, Xos^Efs, Isa, Isa, Isa, Isa, Isa, Isa, Isa, Isa, Isa, Isa, Xos^Efs, Xos^Efs, Xos^Efs, Xos, Xos, Xos, Xos, Xos, Xos, Xos, Xos, Xos
Xos, Xos, Xos, Xos, Xos, Xos, Xos, Xos, Xos, Xos, Xos^Efs, Xos^Efs, Isa, Xos^Efs, Xos^Efs, Isa, Isa, Isa, Isa, Isa, Isa, Isa, Xos^Efs, Xos^Efs, Isa, Isa, Isa, Xos^Efs, Xos^Efs, Xos, Xos, Xos, Xos, Xos, Xos, Xos
Xos, Xos, Xos, Xos, Xos, Xos, Xos, Xos, Xos^Efs, Xos^Efs, Isa, Isa, Isa, Isa, Isa, Xos^Efs, Xos^Efs, Isa, Isa, Isa, Isa, Xos^Efs, Isa, Isa, Isa, Isa^Vhcr, Isa, Isa, Isa, Xos^Efs, Xos^Efs, Xos, Xos, Xos, Xos, Xos
Xos, Xos, Xos, Xos, Xos, Xos, Xos^Efs, Xos^Efs, Isa, Xos^Efs, Xos^Efs, Isa, Isa, Isa, Isa, Isa, Isa, Xos^Efs, Xos^Efs, Isa, Isa, Isa, Isa, Isa, Isa, Isa, Isa, Isa, Isa, Isa, Isa, Xos^Efs, Xos, Xos, Xos, Xos
Xos, Xos, Xos, Xos, Xos, Xos, Xos^Efs, Isa, Isa, Isa, Isa, Xos^Efs, Xos^Efs, Isa, Isa, Isa, Isa, Isa, Isa, Isa, Isa, Isa, Isa, Xos^Efs, Xos^Efs, Isa, Isa, Isa, Isa, Isa, Isa, Xos^Efs, Xos, Xos, Xos, Xos
Xos, Xos, Xos, Xos, Xos, Xos, Xos^Efs, Isa, Isa, Isa, Isa, Isa, Isa, Xos^Efs, Xos^Efs, Isa, Isa, Isa, Isa, Isa, Xos^Efs, Isa, Isa, Isa, Isa, Xos^Efs, Xos^Efs, Isa, Isa, Isa, Isa, Xos^Efs, Xos, Xos, Xos, Xos
Xos, Xos, Xos, Xos, Xos, Xos, Xos^Efs, Isa, Isa, Isa, Isa, Isa, Isa, Isa, Isa, Isa, Isa, Isa, Xos^Efs, Xos^Efs, Isa, Isa, Isa, Isa, Isa, Isa, Isa, Xos^Efs, Xos^Efs, Isa, Isa, Xos^Efs, Xos, Xos, Xos, Xos
Xos, Xos, Xos, Xos, Xos, Xos, Xos^Efs, Xos^Efs, Xos^Efs, Isa, Isa, Isa, Isa, Isa, Isa, Isa, Xos^Efs, Xos^Efs, Isa, Isa, Isa, Isa, Xos^Efs, Isa, Isa, Isa, Isa, Isa, Isa, Xos^Efs, Xos^Efs, Xos^Efs, Xos, Xos, Xos, Xos
Xos, Xos, Xos, Xos, Xos, Xos, Xos^Efs, Isa, Isa, Xos^Efs, Xos^Efs, Isa, Isa, Isa, Isa, Xos^Efs, Isa, Isa, Isa, Isa, Isa, Isa, Isa, Xos^Efs, Xos^Efs, Isa, Isa, Isa, Isa, Isa, Isa, Xos^Efs, Xos, Xos, Xos, Xos
Xos, Xos, Xos, Xos, Xos, Xos, Xos^Efs, Isa, Isa, Isa, Isa, Xos^Efs, Isa, Isa, Isa, Isa, Isa, Isa, Xos^Efs, Isa, Isa, Isa, Isa, Isa, Isa, Xos^Efs, Xos^Efs, Isa, Isa, Isa, Isa, Xos^Efs, Xos, Xos, Xos, Xos
Xos, Xos, Xos, Xos, Xos, Xos, Xos^Efs, Isa, Isa, Isa, Isa, Isa, Isa, Isa, Xos^Efs, Xos^Efs, Isa, Isa, Isa, Xos^Efs, Xos^Efs, Isa, Isa, Isa, Isa, Isa, Isa, Xos^Efs, Xos^Efs, Isa, Isa, Xos^Efs, Xos, Xos, Xos, Xos
Xos, Xos, Xos, Xos, Xos, Xos, Xos^Efs, Isa, Isa, Isa, Isa, Isa, Xos^Efs, Xos^Efs, Isa, Isa, Isa, Isa, Isa, Isa, Isa, Xos^Efs, Xos^Efs, Isa, Isa, Isa, Isa, Isa, Isa, Xos^Efs, Isa, Xos^Efs, Xos, Xos, Xos, Xos
Xos, Xos, Xos, Xos, Xos, Xos, Xos, Xos^Efs, Xos^Efs, Isa, Xos^Efs, Xos^Efs, Isa, Isa, Isa, Isa, Xos^Efs, Isa, Isa, Isa, Isa, Isa, Isa, Xos^Efs, Xos^Efs, Isa, Xos^Efs, Isa, Isa, Xos^Efs, Xos^Efs, Xos^Efs, Xos, Xos, Xos, Xos
Xos, Xos, Xos, Xos, Xos, Xos, Xos, Xos, Xos, Xos^Efs, Xos^Efs, Isa, Isa, Isa, Isa, Isa, Isa, Xos^Efs, Xos^Efs, Isa, Isa, Isa, Isa, Isa, Isa, Xos^Efs, Isa, Xos^Efs, Xos^Efs, Xos^Efs, Xos, Xos, Xos, Xos, Xos, Xos
Xos, Xos, Xos, Xos, Xos, Xos, Xos, Xos, Xos, Xos, Xos, Xos^Efs, Xos^Efs, Isa, Isa, Isa, Isa, Isa, Isa, Xos^Efs, Xos^Efs, Isa, Isa, Isa, Isa, Isa, Xos^Efs, Xos^Efs, Xos, Xos, Xos, Xos, Xos, Xos, Xos, Xos
Xos, Xos, Xos, Xos, Xos, Xos, Xos, Xos, Xos, Xos, Xos, Xos, Xos, Xos^Efs, Xos^Efs, Isa, Isa, Isa, 1 Isa, Isa, Isa, Xos^Efs, Xos^Efs, Isa, Xos^Efs, Xos^Efs, Xos, Xos, Xos, Xos, Xos, Xos, Xos, Xos, Xos, Xos
Xos, Xos, Xos, Xos, Xos, Xos, Xos, Xos, Xos, Xos, Xos, Xos, Xos, Xos, Xos, Xos^Efs, Xos^Efs, Isa, Isa, Isa, Isa, Isa, Xos^Efs, Xos^Efs, Xos, Xos, Xos, Xos, Xos, Xos, Xos, Xos, Xos, Xos, Xos, Xos
Xos, Xos, Xos, Xos, Xos, Xos, Xos, Xos, Xos, Xos, Xos, Xos, Xos, Xos, Xos, Xos, Xos, Xos^Efs, Xos^Efs, Isa, Xos^Efs, Xos^Efs, Xos, Xos, Xos, Xos, Xos, Xos, Xos, Xos, Xos, Xos, Xos, Xos, Xos, Xos
Xos, Xos, Xos, Xos, Xos, Xos, Xos, Xos, Xos, Xos, Xos, Xos, Xos, Xos, Xos, Xos, Xos, Xos, Xos^Efs, Rr, Xos^Efs, Xos, Xos, Xos, Xos, Xos, Xos, Xos, Xos, Xos, Xos, Xos, Xos, Xos, Xos, Xos
