Xu, Xu, Xu, Xu, Xu, Xu, Xu, Xu, Xu, Xu, Xu, Xu, Xu, Xu, Xu, Xu, Xu, Xu, Xu, Xu, Xu, Xu, Xu, Xu, Xu, Xu, Xu, Xu, Xu, Xu, Xu, Xu, Xu
Xu, Xu, Xu, Xu, Xu, Xu, Xu, Xu, Xu, Xu, Xu, Xu, Xu, Xu, Xu, Xu, Xu, Xu, Xu, Xu, Xu, Xu, Xu, Xu, Xu, Xu, Xu, Xu, Xu, Xu, Xu, Xu, Xu
Xu, Xu, Xu, Xu, Xu, Xu, Xu, Xu, Xu, Xu, Xu, Xu, Xu, Xu, Xu, Xu, Xu, Xu, Xu, Xu, Xu, Xu, Xu, Xu, Xuf, Xu, Xu, Xu, Xuf, Xuf, Xuf, Xu, Xu
Xu, Xu, Xu, Xu, Xu, Xu, Xu, Xu, Xu, Xu, Xu, Xu, Xu, Xu, Xu, Xu, Xuf, Xu, Xu, Uh^Dr, Uh^Emf, Uh^Em, Uu^Em, Xu, Wwf^Wkf, Xu, Wwf^Wkf, Wwf^Dr, Wwf^Es, Wwf^Es, Xuf, Xu, Xu
Xu, Xu, Xu, Xu, Xu, Xu, Xu, Xu, Xu, Xu, Xu, Xu, Xu, Xu, Wwf^Dr, Xu, Uh, Uh, Wwt, Uh, Wwt, Uu, Wwt, Wwf^Es, Wwrt, Wwf^Wkf, Wwf^Wkf, Wwf^Wkf, Wwf, Wwf^Es, Wwf^Dr, Xuf, Xu
Xu, Xu, Xu, Xu, Xu, Xu, Xu, Xu, Xu, Xu, Xu, Xu, Xu, Wwf^Dr, Wwf^Es, Wwf^Es, Wwrt, Uu, Wwt, Wwt, Wot, Wwt, Wwg^Qhu, Wwrt, Wwrt, Wwt^Wkf, Wwt, Wwt^Wkf, Wwf, Wwf^Dr, Wwf^Dr, Xu, Xu
Xu, Xu, Xu, Xu, Xu, Xu, Xu, Xu, Xu, Xu, Xu, Xu, Xuf, Wwf, Wwf^Dr, Wwrt, Wwt, Wwrt, Wwr^Qhu, Wot, Wog^Qhu, Wog^Qhu, Qxua, Wwrg^Qhu, Wwrg^Qhu, Wwrt, Wwt, Wwt, Wwt, Wwf^Es, Xuf, Xu, Xu
Xu, Xu, Xu, Xu, Xu, Xu, Xu, Xu, Xu, Xu, Xu, Xuf, Wwf^Wkf, Xuf, Wot, Wwt, Wwt, Wwr^Qhu, Ww^Ewl, Wo^Qhu, Wog^Qhu, Qxua, Isa^Ii, Qxua^_mll, Wwrg^Qhu, Wwt, Wot, Wot, Wwt^Wkf, Xuf, Xuf, Xu, Xu
Xu, Xu, Xu, Xu, Xu, Xu, Xu, Xu, Xu, Xu, Wwf^Es, Wwf^Es, Wwt^Wkf, Wwt^Wkf, Wot, Wwt, Ww^Qhu, Wo^Qhu, Wo^Ewl, Ww^Ewf, Urb^Eb, Urb^Qhu, Urb^Qhu, Qxua, Wwg^Qhu, Wwt, Wwt, Wot, Wwt, Wwt^Wkf, Wwf, Xuf, Xu
Xu, Xu, Xu, Xu, Xu, Xu, Xu, Xu, Xu, Xuf, Wwf^Dr, Wwf^Wkf, Wwt^Wkf, Wwt^Wkf, Wwt, Wwt, Ww^Qhu, Wo^Ewf, Ww^Ewf, Ww, Isa, Isa^_ml, Urb^Eb, Wwg^Qhu, Ww, Ww^Qhu, Wo^Qhu, Wwt, Wwt, Wwf, Wwf^Es, Xuf, Xu
Xu, Xu, Xu, Xu, Xu, Xu, Xu, Xu, Xu, Xuf, Xuf, Xuf, Wwf, Wwrt, Wwt, Wwt, Wwf, Ww^Qhu, Wwf^Qhu, Ww, Wwf, Isa, Wwr, Ww, Ww^Qhu, Ww^Ewf, Wo^Qhu, Wot, Wwt^Wkf, Wwt^Wkf, Wwt^Wkf, Uh, Xu
Xu, Xu, Xu, Xu, Xu, Xu, Xu, Xu, Xu, Xu, Xu, Xuf, Xuf, Wwrt, Wwrt, Wwf, Wwf, Wwf, Wwf^Qhu, Wwf, Wwf^Qhu, Ww, Wwr^Qhu, Wwr^Qhu, Wwrt, Wo^Qhu, Wot, Wot, Uu, Wwt^Wkf, Xu, Xu, Xu
Xu, Xu, Xu, Xu, Xu, Xu, Xu, Xu, Xu, Xu, Xu, Xuf, Uh, Wwrt, Wwf^Es, Wwf, Wwf, Wwf^Qhu, Wwf^Qhu, Wwf^Qhu, Wwf, Ww^Qhu, Wwrt, Wwrt, Wwrt, Wwrt, Wwrt, Wwt, Uu^Tf, Uu^Emf, Xu, Xu, Xu
Xu, Xu, Xu, Xu, Xu, Xu, Xu, Xu, Xu, Xu, Xu, Xuf, Xu, Uh, Uu, Wwf, Wwf^Wkf, Wwf, Wwf, Wwf, Wwf, Wwt, Xu, Wwrt, Wwf^Dr, Wwf, Wwf^Es, Uu^Es, Uu^Em, Uh^Tf, Uh^Dr, Xu, Xu
Xu, Xu, Uh^Emf, Uh^Tf, Xu, Xu, Xu, Xu, Xu, Xu, Xu^Efs, Xu, Xu, Uh, Xu, Wwf, Wwt^Wkf, Wwt^Wkf, Wwf^Dr, Wwf^Dr, Wwf^Dr, Wwf^Es, Xu, Xu, Xu, Xu, Xu, Uh^Em, Xu, Uh^Emf, Xu, Xu, Xu
Xu, Xu, Xu, Uh^Em, Uu^Dr, Uh^Emf, Xu, Xu, Uh, Uh, Uh, Uu^Em, Uu, Xu, Xu, Xu, Xuf, Wwf^Wkf, Xuf, Wwf^Dr, Xu, Wwf^Es, Xu, Xu, Xu, Xu, Xu, Xu, Xu, Xu, Xu, Xu, Xu
Xu, Xu, Xu, Rb^Es, Rb, Uh, Uu^Vct, Xu, Rb, Uh, Rb, Rb, Xu, Xu, Xu^Qhu, Xu, Xu, Xuf, Xu, Xuf, Xu, Xu, Xu, Xu, Xu, Xu, Xu, Xu, Xu, Xu, Xu, Xu, Xu
Uu^Tf, Uu^Tf, Rb^Em, Rb^Vct, Rb^Ecf, Rb^Em, Uu, Rb, Uu, Rb^Es, Uu, Wwf, Rb, Xu^Qhu, Uu, Xu^Qhu, Xu^Qhu, Xu, Xu, Xu, Xu, Xu, Xu, Xu, Xu, Xu, Xu, Xu, Xu, Xu, Xu, Xu, Xu
Uu^Emf, Uu^Tf, Uu^Em, Rb^Em, Rb^Es, Uu, Uh, Uu, Uh, Rb, Uh, Uu, Rb^Qhu, Rb^Qhu, Wwg, Wwg, Xu^Efs, Xu^Qhu, Xu, Xu, Xu, Xu, Xu, Xu, Xu, Xu, Xu, Xu, Xu, Xu, Xu, Xu, Xu
Xu, Uu^Emf, Xu, Wwg, Wwf^Dr, Uh, Uh, Xu, Xu, Uh^Dr, Uh^Es, Wwg^Qhu, Wwf^Dr, Rb^Emf, Rb^_ml, Uh, Uh, Xu^Qhu, Xu, Xu, Xu, Xu, Xu, Xu, Xu, Xu, Xu, Xu, Xu, Xu, Xu, Xu, Xu
Xu, Xu, Xu^Efs, Wwf, 1 Rb^Es, Xu, Xu, Xu, Xu, Uh^Br|, Uh^Eb, Wwf^Qhu, Xu^Qhu, Rb, Rb^Emf, Uh^Tf, Uh^Dr, Xu^Qhu, Xu, Xu, Xu, Xu, Xu, Xu, Xu, Xu, Xu, Xu, Xu, Xu, Xu, Xu, Xu
Uh, Xu, Rb^Dr, Rb^Em, Rb^Es, Uu^Es, Uu, Uh, Uh^Tf, Uh^Br|, Xu, Xu, Xu^Qhu, Uu^Emf, Uu^Emf, Uu^Em, Uh, Xu^Qhu, Xu^Qhu, Xu, Xu, Xu, Xu, Xu, Xu, Xu, Xu, Xu, Xu, Xu, Xu, Xu, Xu
Uu, Uu, Rb, Rb, Uh, Uh, Xu, Xu, Xu, Uh^Br\, Uh^Br\, Xu, Xu, Xu^Qhu, Uu, Uu, Uh, Uh, Xu^Qhu, Xu, Xu, Xu, Xu, Xu, Xu, Xu, Xu, Xu, Xu, Xu, Xu, Xu, Xu
