Gg, Hh, Hh, Hh, Gg^Es, Gg, Gg, Gd, Gd, Gg, Gd, Gg, Gg, Gg^Efm, Gg^Efm, Gg, Gs, Gg, Re, Re, Hh^Em, Mm, Mm, Mm, Mm, Hh^Fp, Mm^Xm, Hh^Fp, Hh^Fp, Mm^Xm, Mm^Xm, Hh^Fp, Mm, Mm^Xm, Mm^Xm, Mm^Xm, Mm^Xm, Mm^Xm
Gg^Es, Gs, Hh, Hh, Gs^Es, Gs^Es, Gs, Gd, Hh, Hh, Gg, Gg, Gg, Gg^Efm, Gs^Fp, Gs, Gs, Gg^Efm, Re^Em, Re^Em, Hh, Hh^Em, Mm, Mm, Mm, Mm, Mm, Mm^Xm, Mm, Hh, Hh^Fp, Hh^Fp, Mm, Mm, Mm, Mm, Mm, Mm^Xm
Gg, Gs, Hh, Hh, Hh, Hh, Hh, Hh, Hh, Hh, Gg^Efm, Gd, Gd^Edt, Gs^Fp, Rr^Ii, Gs^Fp, Gd, Gd^Vhr, Re, Hh, Hh^Fp, Hh^Fp, Hh^Fp, Hh^Fp, Hh, Hh, Mm, Mm^Xm, Mm, Hh^Fp, Gs^Edt, Hh, Hh^Es, Hh, Hh, Hh^Fp, Mm^Xm, Mm^Xm
Gg, Gd, Gd, Gd, Hh, Mm, Mm^Xm, Mm, Mm, Gg, Mm, Gg, Gd^Edt, Gs^Fp, Gs^Fp, Gs^Fp, Re, Re, Gd^Edt, Hh, Hh^Vhh, Hh, Hh, Hh, Hh, Hh, Mm, Mm, Gs^Fms, Gs^Fms, Gg^Efm, Gs, Cvr^Es, Hh, Mm^Xm, Hh, Mm^Xm, Mm
Gg, Gg, Hh, Mm, Mm^Xm, Mm, Mm, Mm, Mm, Hh, Mm, Gg, Hh, Gd^Edt, Gg, Gg, Re, Gs, Gd^Edt, Hh, Hh, Hh, Mm, Mm, Mm, Mm, Mm, Hh^Fms, Mm, Hh^Fp, Gd, Cvr, 2 Kvr, Cvr^Es, Mm^Xm, Mm, Hh^Fp, Mm
Gg, Hh, Hh, Mm, Mm, Mm^Xm, Mm^Xm, Mm, Hh, Hhd^Vhhr, Hh, Hh, Hh^Em, Gg, Hh, Re, Gd^Edt, Gd^Edt, Mm, Mm, Mm, Mm, Mm^Xm, Mm, Mm, Mm, Mm, Mm, Hh, Gs^Edt, Gg^Efm, Cvr, Cvr, Cvr, Mm, Mm, Hh^Fp, Mm
Mm, Mm, Mm, Mm, Mm, Mm, Mm, Mm, Hh, Hh, Hh, Hh, Hh^Em, Hh, Gg, Re, Gd^Dr, Gd, Gd, Mm, Mm, Mm^Xm, Mm, Mm, Mm, Mm, Hh, Mm, Gs^Fms, Gs^Fp, Gg^Ve, Gg^Efm, Re^Es, Gs, Hh^Fp, Hh, Gs^Fp, Hh
Mm, Mm, Mm^Xm, Mm, Mm, Mm, Mm, Mm, Gs, Hh, Hh, Hh^Em, Mm^Xm, Mm^Xm, Gg, Re, Gg^Efm, Gs, Gs, Mm, Mm, Mm, Mm^Xm, Hh^Fet, Hh^Fms, Mm, Hh, Hh^Fms, Hh^Fms, Gs^Fms, Hh^Fms, Hh, Re, Hh^Fp, Hh^Fp, Gg^Ve, Hh^Fp, Gs^Fp
Mm, Mm, Mm, Mm, Mm, Mm, Mm, Hh, Gg^Efm, Gs^Efm, Hh, Mm, Mm, Hh, Gs, Gd^Vhr, Gg^Efm, Gs, Gs, Mm, Gs^Fp, Hh^Fp, Hh^Fms, Mm, Hh^Fp, Mm, Hh, Hh^Fms, Gs^Edt, Gs^Fms, Gs^Fms, Gs^Fms, Re, Hh^Em, Hh, Gs^Fp, Hh, Gs^Fp
Mm, Mm, Mm, Mm, Mm, Mm, Mm, Hh, Gg^Efm, Gg^Efm, Gg^Efm, Hh, Re, Mm, Re, Re, Gg^Efm, Gs^Fmw, Gs, Gg^Efm, Gg^Efm, Gs^Fms, Hh^Fms, Mm, Gs^Edt, Hh, Gs^Fms, Gg^Efm, Gd, Mm, Mm, Mm, Re^Es, Hh^Efm, Hh^Em, Gs^Fp, Hh, Gs^Fp
Mm, Mm, Mm^Xm, Mm^Xm, Mm, Mm, Hh, Gs, Gs, Gg, Gg, Re, Hh, Re, Gd, Hh, Gs^Fmw, Gs^Fmw, Hh, Gs^Fmw, Gs^Fmw, Gg^Efm, Hh^Fms, Mm, Gs^Edt, Gs^Fms, Gs^Fp, Gs^Fp, Gs^Fp, Mm, Mm^Xm, Mm, Re^Es, Hh, Hh, Hh, Hh^Fp, Gs^Fp
Mm, Mm, Mm, Mm, Hhd^Vhhr, Mm, Mm, Gs, Gll, Gg, Gd^Vhr, Re, Gs, Gd, Gs, Gs, Gg^Efm, Gs^Fmw, Gs^Fmw, Gs, Gs^Fmw, Gs, Gs^Fms, Gs^Fms, Gs^Edt, Gg^Ve, Gs^Fp, Gs^Fp, Gs^Fp, Mm, Mm, Mm, Re, Gs^Fp, Gs^Fp, Hh^Fp, Hh, Hh^Fp
Mm, Mm, Mm, Hhd^Em, Mm, Mm^Xm, Mm, Gs, Gll, Gll, Re, Re, Gs, Gd, Gs^Edp, Gg^Efm, Gs, Gg^Efm, Gs, Gs, Gs^Fmw, Gs^Fms, Gg^Efm, Gs^Fp, Gg^Efm, Gs^Fp, Gs^Fp, Gs^Edt, Gd, Gs^Fp, Mm^Xm, Mm, Re, Gg^Ve, Gs^Fp, Hh, Gs^Fp, Gs^Fp
Mm, Mm, Hhd, Hhd, Gs, Mm, Gs, Gs, Re^Efm, Re, Gd^Dr, Gs, Gd^Edp, Gd^Edp, Gs^Edp, Gg^Efm, Gg, Gs^Fmw, Gs^Fmw, Gs, Gg, Gs^Fmw, Gs^Fp, Gg^Efm, Gd, Gs^Fp, Mm, Gs^Fp, Gg^Efm, Mm, Mm, Mm, Mm, Gs^Fp, Hh^Fp, Hh^Fp, Gs^Fp, Gs^Fp
Mm, Hh, Gg, Gg, Gg^Efm, Gd^Vhr, Re, Re, Gg^Efm, Gg^Efm, Gs, Gs, Gs, Gs, Gs, Gg, Gd^Vo, Gs^Fmw, Gs^Fmw, Gs, Gs, Gs^Fmw, Ww, Ww^Ewf, Gg^Efm, Gg^Efm, Mm, Mm, Mm, Mm, Mm, Mm, Mm, Gs^Fp, Hh^Fp, Hh, Gg^Ve, Rr
Gs^Fp, Gs, Gg, Gg^Efm, Gg^Efm, Gs, Re, Gg^Efm, Gs, Gs, Gs, Re, Gll, Gs, Gg, Gg^Efm, Gg^Efm, Gg, Gg^Efm, Gg^Efm, Gg^Efm, Gs^Fmw, Gs^Fp, Gs^Fp, Gg, Gs, Gs^Fp, Gg^Ve, Hh^Fp, Hh^Fp, Hh^Fp, Re, Gs^Fp, Hh^Fp, Hh, Hh, Gs^Fp, Rr
Gg, Gg, Gg^Efm, Gg^Es, Gs, Gs, Re, Gg, Gs, Gs, Gs, Re, Re, Gd, Gs, Gs, Gs, Gg^Efm, Gs^Fp, Ww, Gs^Fp, Gs^Fp, Gs^Fp, Gg, Gg, Gs^Fp, Hh^Fp, Hh^Fp, Gs^Fp, Gd, Gg^Efm, Re, Gs^Fp, Hh, Gs^Fp, Gs^Fp, Re, Hh
Gg, Gg, Gg^Efm, Gg^Efm, Gs, Gs, Re, Gg, Gd, Gs^Edp, Gs^Edt, Rp^Vhcr, Gs^Efm, Gd^Efm, Gs, Gs, Gs^Edt, Gs, Gs, Gs^Fp, Gs^Fp, Gs^Fp, Hh^Fp, Hh^Fp, Hh^Fp, Gg, Gs^Fp, Hh, Gs, Gg^Efm, Re^Es, Re, Gs^Fp, Hh, Hh, Hh^Fp, Re, Hh
Gg, Gg, Gs, Gs, Re, Re, Gs, Gg, Gd^Efm, Gs^Efm, Gd^Edt, Gs^Efm, Gs^Edt, Gs^Efm, Gd^Edt, Gs^Edt, Gs, Gs, Gs, Gs^Fp, Ww, Gs^Fp, Gs^Fmw, Hh, Hh^Fp, Gg, Hh^Fp, Gs^Fp, Re, Hh, Re, Hh^Fp, Hh, Mm, Mm, Hh, Re, Gg^Efm
Gg, Gs, Gs, Re, Gd, Gd, Gs, Gs, Gd, Gs, Gd, Gd^Edt, Gd^Edt, Gd, Gd^Vo, Gs^Edt, Gs, Gd, Gg, Gd^Vo, Gs^Fp, Gs^Fp, Gs^Fmw, Hh^Fp, Gg^Efm, Gg, Re, Re, Hh, Re, Hhd, Hhd, Hh, Mm, Hh, Gg^Efm, Re, Gs
Gs, Gs, Gg, Re, Gd, Gs, Gs, Gs, Gd, Gd, Gs^Fp, Gs^Fp, Gs, Gd, Co, Gd^Edt, Gd^Edt, Gd, Gs, Gg, Gs^Fmw, Hh, Gs^Fmw, Hh^Em, Hh^Em, Gg^Efm, Re, Hh^Fmw, Hh^Fp, Hhd, Hh, Hhd^Vhhr, Mm, Hh, Hh^Fp, Hh^Efm, Re, Gg^Efm
Gs, Gs, Gs, Re, Gd, Gs, Gd, Gs^Fp, Gs^Fp, Gg, Gg, Gg, Gs^Edt, Co, 3 Ko, Co, Gs, Gd^Ecf, Gd, Gg, Gg, Gs^Fmw, Hh, Hh^Em, Hh, Gs, Re, Hh^Fmw, Hhd, Hhd, Mm^Xm, Mm, Mm, Hh, Gd, Gg^Efm, Re, Gg^Efm
Gs, Gs, Gs, Re, Gd^Em, Gd, Gd^Em, Gd^Em, Gs^Edt, Gs, Gs^Edt, Gd^Vo, Gs^Edt, Co, Co, Co, Gs^Edt, Gd, Gd, Gg, Gg, Hh, Mm, Hh, Re, Re, Gg, Hh, Hhd, Hh, Mm^Xm, Mm^Xm, Mm, Hh, Gg, Gg, Re, Hh
Gs, Gd, Re, Re, Gd, Gd^Em, Gd^Vo, Gs^Em, Gd, Gs^Edt, Gs, Gs^Edt, Gs^Edt, Gs^Edt, Gg^Edt, Gs^Edt, Gs, Gd^Edt, Gd, Gs, Gg, Hh, Gg, Gg, Re, Gg, Gs^Em, Gs, Hhd, Hh, Mm, Mm^Xm, Mm^Xm, Hh, Hh, Hh, Hh, Hh
Re, Re, Gd, Gd, Gd, Gd^Edt, Gd^Edt, Gs, Gs^Edt, Gs, Gs, Gs, Gs, Gg, Mm, Gg, Gs, Gs, Gs, Mm, Gg, Gg, Gs, Gd, Re, Hh, Gs, Hh^Em, Hhd, Hh, Mm^Xm, Mm, Hh, Hh, Gg, Gg, Re, Hh
Gs, Gs, Gd, Gd, Gd, Gd^Edt, Gs, Gd^Edt, Gd^Edp, Gd^Edp, Gs, Gs^Edp, Gs, Gg, Mm, Gg^Efm, Gg, Gs, Gs, Gs, Gs^Edp, Gs, Gll^Edp, Gd, Re, Hh, Hh^Em, Hh^Em, Mm, Mm, Mm, Hh, Hh, Hh, Gs^Edp, Gd, Re, Gg
Gs^Edt, Gs, Gs, Gs, Gs, Gs^Edt, Gs, Gs, Gd^Edp, Gs, Gg^Edt, Gs, Gg, Gg, Gs, Gg, Gs, Gs, Hh, Gs, Gs, Gs^Edp, Gs^Edp, Gs, Re, Gs, Hh, Mm, Mm, Mm^Xm, Mm, Mm, Hh, Gg, Gs, Gs^Fp, Re^Efm, Gg
Gs^Edt, Gs, Gs^Em, Gs, Gs, Gs^Edt, Gd, Gs, Gd, Gs, Gs, Gg, Gg, Gg, Gg, Gg^Edp, Gs, Gd, Gd, Gd^Edp, Gd, Gs^Vl, Gd, Gd, Re, Gs, Hh, Mm, Mm, Mm, Mm, Mm, Gs^Fp, Gg^Efm, Re, Re, Hh, Gg
Gs^Edt, Gs, Gd, Gs, Gs, Gs, Gs, Gd, Gs, Gs, Gs, Gg^Efm, Gg^Efm, Gg, Gg, Gs, Gd, Gd, Gg^Efm, Gg^Efm, Gg^Efm, Gs, Gd, Gs, Re^Es, Gs, Hh, Mm, Mm, Mm, Mm, Hh, Re, Re, Gs^Efm, Hh^Fmw, Gs^Fmw, Gg
Gs, Gs^Edt, Gd, Mm, Gg, Gg, Gg, Gs, Hhd, Hhd, Gg, Gg, Gg^Efm, Gg, Gg^Efm, Gd^Vo, Gs, Gs, Gs, Gg^Efm, Gs, Gs, Gs, Gs, Re^Es, Gs, Hh, Hh, Mm, Hh, Gs, Re, Gd, Gs^Edp, Gs, Gs^Fmw, Gs^Fp, Gd
Gs, Gd, Mm, Gd, Mm, Gg, Gs, Hhd^Em, Hh, Gg, Gs, Gs^Edp, Gs, Gs^Efm, Gs, Gg^Efm, Gd, Gs, Gs, Gd, Gd, Gd, Gs, Re^Es, Gg, Gs, Mm^Xm, Mm, Hh, Hh, Re, Re, Gd, Gs, Gd, Gs^Fp, Gd, Gd
Mm, Mm, Gs, Mm, Gg, Gg, Hhd^Em, Hhd^Em, Hh, Gg, Gs^Edp, Gs^Edp, Gs, Gs, Gll^Edp, Gll, Gd, Gs, Gs^Edt, Gs^Edt, Gg^Edt, Gg^Edt, Gd^Edt, Re, Gg, Gs, Hh^Emf, Hh, Hh^Em, Hh^Em, Re, Gd, Gs^Edt, Gg^Efm, Gs, Gd, Gg^Edt, Gg
Mm, Mm, Gs^Vht, Gs, Gg, Gs, Hhd^Em, Hhd^Em, Hh, Gg, Gs, Gs, Gd, Gd, Gll, Gll, Gs, Gs, Gs^Efm, Gs^Efm, Gg, Gg, Gd^Edt, Re, Gs^Vh, Gs, Gs, Hh^Em, Hh, Re^Es, Gd^Es, Gd, Gs^Edt, Gg^Edt, Gg^Edt, Gg^Edt, Gg, Gg^Edt
Mm, Gs, Gs, Gs, Gs, Hh, Hh, Hh^Em, Hh, Hhd, Gs, Gd^Dr, Gd, Gd, Gd, Gd, Gd^Efm, Gs^Efm, Gg^Efm, Gg, Gd, Gd, Cer, Re, Gg, Gg^Edp, Gg^Edp, Hh^Em, Re, Re, Gd, Gs, Gll^Edt, Gd, Gg, Gg^Fmw, Gs^Fmw, Gg
Mm, Gs, Mm, Hh, Hh, Hh, Mm, Hh^Em, Hh, Hhd, Hhd, Gd, Gs, Gs, Gs, Gs, Gg, Gg, Gg, Gg, Gd, Cer, 1 Ker, Cer, Gs^Edt, Gs^Fp, Gg, Re, Hh^Em, Gd, Gs, Gs, Gg, Gd, Gs^Edp, Gd, Gs^Fmw, Gs^Fmw
Mm, Mm, Hh^Em, Mm, Mm^Xm, Mm^Xm, Mm, Hh, Hhd, Hhd, Hhd^Vhhr, Hhd^Em, Gd, Gs, Hh, Gs, Gd, Gg, Gg, Gd^Edt, Gg, Cer, Cer, Cer, Gs^Edt, Gs, Gs^Edp, Re, Re, Gd^Es, Gg, Gg, Gg^Efm, Gd^Efm, Gd, Gs^Fmw, Gs^Efm, Gs^Fp
Hh, Hh^Em, Mm, Mm, Mm, Mm, Mm, Hh, Hhd, Hhd^Em, Hhd, Hhd^Em, Gd, Gs, Hh, Gs, Gd, Gd, Hh^Edt, Gd^Edt, Gd^Edt, Gd^Dr, Gg, Re, Gs, Gs^Edt, Gs, Gs, Re, Gd^Dr, Gs, Gg^Efm, Gg, Gg^Efm, Gd^Efm, Gs, Gg, Gs^Fp
Hh, Mm, Hh, Mm^Em, Mm, Hh, Hh^Em, Hh, Hh, Hhd, Hhd, Hhd^Em, Hh^Em, Gd^Em, Gd^Em, Gd, Hh^Vhh, Hh, Hh^Edt, Gd^Edt, Gd, Gg, Gg, Re, Gs, Gg, Gg, Gg, Hh, Re, Gs^Efm, Gs, Gs^Edp, Gs^Ecf, Gs^Edp, Gs^Efm, Gs^Edt, Gs^Edt
Hh, Mm, Mm, Mm, Mm, Hh, Mm, Hh, Hh, Hh, Hhd, Hhd, Hh, Hh^Em, Hh, Hh, Hh, Hh, Hh, Hhd, Hhd, Gg, Re^Es, Re, Gs, Hh, Hh, Hh, Re, Re, Gs, Gs, Gs, Gs^Edp, Gg, Gs, Gs, Gs^Edt
Hh, Hh, Hh, Hh, Hh, Mm, Mm, Mm, Mm, Hh, Hh, Hh, Hh, Hh, Hh, Hh, Hhd, Hhd, Hhd, Hhd, Hhd, Gg, Re, Re, Gs, Hh, Hh, Hh, Re, Gs, Gd, Gd, Gg, Gg, Gg, Gg, Gg, Gg^Edt
