Hh, Mm, Hhd^Fp, Mm, Mm, Mm, Mm, Mm, Gs^Fp, Gs^Fp, Gg^Efm, Gs, Ww^Wkf, Ww^Wkf, Gg, Gg, Hhd^Emf, Mm, Mm, Hh, Hhd^Fp, Mm, Mm, Mm, Hh^Fp, Mm, Mm, Mm^Xm, Mm, Mm
Mm, Mm, Mm, Mm, Hh^Fp, Mm, Hh, Gs^Fp, Gg, Gg, Gs^Fds, Gs, Gd, Wwr, Gs^Fp, Gg^Efm, Hh^Fp, Hhd^Em, Mm, Mm, Hh, Hh^Em, Hh^Fp, Hh^Fp, Gs^Fp, Hh^Em, Gs^Fp, Mm, Hh^Fp, Mm
Mm, Mm, Mm, Mm, Mm, Hh^Fp, Hhd^Fp, Gg, Gs, Gs^Fds, Rr^Ii, Gs^Fms, Gd, Wwr, Wwf, Gs^Fp, Mm, Mm, Hh^Fp, Hh^Fp, Gs^Fp, Wwf, Gg^Ve, Gs^Fp, Cvr, Cvr, Cvr, Gs^Fp, Hh^Fp, Hh
Hh^Fp, Mm, Mm, Mm, Mm, Hh, Hhd^Fp, Gg^Efm, Gs^Efm, Gs^Fds, Gs^Fms, Gs^Fms, Gg, Ww^Ewl, Wwf, Gs^Fp, Wwf, Hh^Fp, Gg^Efm, Gs^Fp, Wwf, Gg^Efm, Gg, Gs^Fp, Cvr, 2 Kvr, Cvr, Gs^Fp, Hhd, Mm
Hh^Em, Mm, Mm, Hh^Fp, Hh^Fp, Hh^Fp, Hhd^Fp, Gg, Gg^Efm, Gs, Gg, Gg^Efm, Gg, Ww^Ewf, Ww^Ewl, Wwf, Gg, Gg^Efm, Gg^Ve, Gs^Fp, Hhd, Hhd^Em, Mm, Gs, Gd, Cvr, Wwf, Gs^Fp, Gs^Fp, Hhd^Em
Hh^Em, Hh^Fp, Mm, Mm, Mm, Hh^Em, Hh^Emf, Hhd^Fp, Gg, Gg^Ve, Gs^Fp, Gs^Fp, Gd^Es, Gs^Es, Gg, Gg, Gs^Fp, Gs^Fp, Gs^Fp, Gd, Mm, Mm, Mm, Hhd^Em, Hhd^Em, Wwf, Gs^Fp, Wwf, Ww^Wkf, Gs^Fp
Hh, Mm, Mm, Mm, Mm, Mm, Hh^Em, Gs, Gs^Fp, Gg, Gg, Gg, Gs, Ww^Wkf, Ww^Ewl, Gg, Wwf, Wwf, Hh, Gs^Fp, Mm, Mm, Mm^Xm, Hhd^Emf, Mm, Wwf, Gs^Fp, Gd^Es, Gs^Fp, Ww^Wkf
Mm, Mm^Xm, Mm, Mm, Mm, Mm, Mm, Hh, Hh^Vhh, Gs^Fp, Gg, Gs^Fp, Gg, Gs^Es, Wwr, Wwr, Wwf, Hh^Fp, Mm, Hh^Fp, Mm, Mm, Mm, Mm, Mm, Gs^Fp, Gs^Fp, Gg^Ve, Gs^Fp, Gs^Fp
Hhd^Fp, Mm, Hhd^Fp, Hhd^Emf, Hh^Em, Mm, Hh^Fp, Hh^Fp, Gg, Hh^Fp, Hh^Fp, Gg, Ww, Gs^Fp, Wwr, Gg, Gs^Fp, Hhd^Em, Hh^Emf, Mm, Mm, Mm, Mm, Mm, Hhd, Gs^Fp, Gg, Gg^Efm, Gg^Efm, Gs^Fp
Hhd^Fp, Hh, Hh, Hh^Em, Hh^Fp, Hh^Fp, Co, Co, Co, Gg, Gg^Es, Gg^Efm, Wwr, Gg, Gs^Fp, Gg, Gd^Es, Gg, Gs^Fp, Hh^Fp, Hh^Em, Mm, Gg^Efm, Hh^Fp, Gs^Fp, Gs^Fp, Gg^Efm, Gs^Fp, Wwf, Wwf
Gs, Gs, Gs, Gs^Fp, Gg, Gd, Co, 3 Ko, Co, Wwf, Gg, Gg, Gg^Efm, Ww^Ewl, Gs^Fp, Gd, Hh^Fp, Gs^Fp, Wwf, Gs^Fp, Gg, Gg, Gs^Fp, Wwf, Wwf, Wwf, Gs^Fp, Gs^Fp, Ww^Wkf, Gs^Fp
Hh, Hh^Fp, Gg, Gg^Efm, Gd^Vo, Gd^Es, Gd^Es, Co, Ww^Wkf, Wwf, Gs, Gd^Vo, Gg, Gs^Fp, Gg^Es, Gd^Es, Gs^Fp, Wwf, Gs^Fp, Wwf, Wwf^Es, Gs^Es, Gs^Fp, Gs^Fp, Wwf, Gg^Ve, Gs^Fp, Gs^Es, Gs^Fp, Gs^Fp
Gg, Gg, Hh^Fp, Gg, Gg^Efm, Gg^Efm, Hhd^Fp, Gd, Gs, Gs, Hh, Gs, Gs^Efm, Gg, Gs^Fp, Gd, Hh, Wwf, Hh^Fp, Hh^Fp, Hh^Fp, Gs, Gs, Gs, Gs^Fp, Wwf, Gd^Es, Gd^Es, Wwf, Wwf
Gs^Fp, Hh^Fp, Gg, Gg, Gg, Gg^Efm, Hhd^Fp, Hhd^Fp, Hhd^Fp, Hhd^Fp, Gs^Fp, Hh, Gd, Gg^Efm, Gg^Efm, Gs^Fp, Wwf, Hh, Gs^Fp, Hh^Fp, Gs^Fp, Gg, Gg, Gs^Fp, Gs^Fp, Gs^Fp, Gd, Gs^Fp, Gs^Fp, Gs^Fp
Ww^Wkf, Gg, Hh^Fp, Gs^Fp, Gd^Es, Wwf, Gs^Fp, Gs^Fp, Wwf, Gg, Wwf, Hh, Gd, Gg, Gg^Efm, Gs^Fp, Gs^Fp, Gs^Fp, Gs^Fp, Ww^Wkf, Wwf, Gg, Gs^Fp, Gg, Gg, Gg, Wwf, Gs^Fp, Gg^Efm, Gg
Wwf, Wwf, Gs^Es, Gs^Fp, Gd, Wwf, Ww^Wkf, Gg, Gg, Gs^Fp, Wwf, Gs, Gs^Fp, Gs^Fp, Gs, Gs^Fp, Gg, Gg, Gg, Wwf, Gs^Fp, Gs^Fp, Gs^Fp, Gg, Hh^Fp, Hh^Fp, Wwf, Gs^Fp, Ww^Wkf, Gs^Fp
Gs, Gs^Fp, Gg^Efm, Gs^Es, Gg^Ve, Gs^Fp, Gs, Gs^Fp, Gg, Wwf, Hh, Hh, Gg, Gs^Fp, Gs, Gd, Gg, Gs^Fp, Gs^Fp, Gg^Efm, Gg, Gs^Fp, Gg^Efm, Gg^Efm, Gs, Gs^Fp, Gs, Wwf, Hh^Fp, Gs^Fp
Hhd, Gg, Gs^Fp, Gs^Fp, Gs, Gd, Gs^Fp, Gs^Fp, Hhd^Em, Hh^Fp, Mm, Mm^Xm, Mm, Gg, Gs, Gs^Fp, Gg^Efm, Gg, Gs, Gg, Gg, Gg^Efm, Gs^Vh, Gs, Gg^Es, Gg, Gg, Gg^Efm, Gg, Gg
Hhd, Wwf, Gs^Fp, Gs^Fp, Hhd, Gs^Fp, Hhd^Fp, Hhd^Emf, Mm, Mm^Xm, Mm, Mm, Hhd^Em, Gg, Gs^Fp, Gg, Wwf, Gg, Gd, Gg, Gs^Fp, Gg, Gd^Es, Gg^Es, Cer, Cer, Cer, Gg, Gs^Fp, Gs^Fp
Gs^Fp, Hh^Fp, Hh^Vhh, Hh^Fp, Mm, Mm, Mm, Hhd^Em, Mm, Mm, Mm, Mm, Mm, Hh^Fp, Hh^Fp, Gs^Fp, Wwf, Gs^Fp, Gs^Fp, Gs, Gs, Gg, Gg, Gd, Cer, 1 Ker, Cer, Gs^Es, Gg^Es, Gs^Fp
Gs^Fp, Hh, Mm, Mm, Mm, Mm, Mm^Xm, Mm, Mm, Mm, Mm, Mm, Mm, Mm, Mm, Hhd^Em, Gs^Fp, Wwf, Hh^Fp, Gs^Fp, Gg, Gs^Fp, Gs^Fp, Gd, Gs^Fp, Cer, Gs^Fp, Gs^Es, Gs^Vh, Gg^Efm
Hh, Hh^Fp, Hh^Fp, Mm, Hh, Mm, Mm, Mm, Hh, Mm, Mm, Mm, Hh, Mm, Hh, Hh^Fp, Hhd, Gs^Fp, Gs^Fp, Gs^Fp, Gg, Gs^Fp, Gs^Fp, Wwf, Gg, Gs^Fp, Gg, Gg, Gg^Efm, Gg^Efm
