Hh, Re, Hh, Mm^Xm, Mm, Mm, Mm^Xm, Mm, Mm, Mm^Xm, Mm, Mm, Mm, Mm^Xm, Mm, Mm^Xm, Mm^Xm, Mm^Xm, Mm, Mm, Mm, Mm^Xm, Mm, Mm, Mm, Mm^Xm, Mm, Mm, Mm, Mm^Xm
Hh, Re, Hh, Mm, Hh^Emf, Mm^Xm, Hh, Mm^Xm, Hh^Vo, Mm, Hh^Fdw, Mm, Hh^Fdw, Mm, Mm, Mm, Mm, Mm, Mm, Mm, Mm, Mm, Mm, Mm, Mm, Mm, Mm, Mm, Mm, Mm^Xm
Hh, Re^Efm, Rb^Efm, Hh^Em, Rb, Hh^Em, Re^Es, Hh, Re^Es, Hh, Hh^Fdw, Hh^Fdw, Hh, Hh, Hh, Mm, Mm, Mm, Mm^Xm, Mm, Mm, Mm, Mm^Xm, Mm^Xm, Mm, Mm, Mm, Mm, Mm, Mm^Xm
Mm^Xm, Hh, Hh, Rb^Efm, Hh^Vo, Re, Hh, Re^Dr, Re^Efm, Hh, Chr, Chr, Chr, Rb^Ecf, Re^Efm, Hh, Hh, Mm, Mm, Mm, Mm, Mm, Mm, Mm, Mm, Mm, Mm, Mm, Mm, Mm
Mm^Xm, Mm, Mm, Hh, Hh, Re, Hh, Hh, Hh^Dr, Rb^Es, Chr, 3 Khr, Chr, Hh, Hh^Vo, Re^Efm, Re, Hh, Hh, Mm, Hh^Fdw, Mm, Mm, Mm, Hh, Mm, Mm, Mm, Mm^Xm, Mm^Xm
Mm^Xm, Mm^Xm, Mm, Mm, Mm^Xm, Hh, Mm^Xm, Mm^Xm, Mm^Xm, Hh^Dr, Hh, Chr, Hh^Fmw, Hh^Fmw, Hh, Hh, Hh, Rb, Rb^Efm, Hh, Hh^Fdw, Hh^Fdw, Mm, Hh, Mm, Mm, Mm, Mm, Mm, Mm
Mm^Xm, Mm, Mm, Mm, Mm, Mm^Xm, Mm^Xm, Mm, Mm, Mm, Hh^Fmw, Hh^Fmw, Hh^Fmw, Hh^Fmw, Hh^Emf, Hh^Fmw, Hh^Fmw, Hh, Rb, Hh, Hh^Fdw, Mm, Mm, Mm, Mm, Mm, Mm, Mm, Mm, Mm^Xm
Mm^Xm, Mm^Xm, Mm, Mm, Mm, Mm, Mm, Mm, Mm, Hh^Fmw, Hh, Hh, Hh, Hh^Em, Re^Efm, Hh^Em, Hh, Hh, Re, Hh, Mm, Mm, Mm, Mm, Mm, Mm, Mm^Xm, Mm, Mm, Mm^Xm
Mm^Xm, Mm, Mm, Mm, Mm, Mm, Mm, Mm, Mm, Mm, Hh, Rb, Rb, Rb^Efm, Hh^Em, Re, Re^Es, Hh, Re^Efm, Hh, Hh^Fdw, Mm, Mm, Mm, Mm, Mm^Xm, Mm, Mm, Mm, Mm^Xm
Mm^Xm, Mm^Xm, Mm, Mm, Mm, Mm, Mm, Mm, Mm, Mm, Mm^Xm, Hh, Hh^Em, Hh^Emf, Mm, Hh, Hh^Vhh, Re^Dr, Rb^Efm, Hh, Hh, Hh^Fdw, Hh^Emf, Mm, Mm, Mm, Mm, Mm, Mm^Xm, Mm^Xm
Mm, Mm, Mm, Mm^Xm, Mm^Xm, Mm, Mm, Mm, Mm, Mm^Xm, Mm^Xm, Mm^Xm, Mm^Xm, Mm, Mm, Mm, Mm, Hh, Hh, Re^Efm, Re, Hh^Em, Hh^Em, Hh^Fdw, Mm, Mm, Mm^Xm, Mm^Xm, Mm^Xm, Mm^Xm
Mm^Xm, Mm^Xm, Mm^Xm, Mm, Mm, Mm, Mm, Mm, Mm, Mm, Mm^Xm, Mm^Xm, Mm^Xm, Mm^Xm, Mm^Xm, Mm, Mm, Mm, Mm^Xm, Hh, Hh^Vhcr, Re^Efm, Hh, Mm, Mm, Mm, Mm, Mm^Xm, Mm^Xm, Mm^Xm
Mm, Mm, Mm, Mm^Xm, Mm^Xm, Mm, Mm, Mm, Mm, Mm^Xm, Mm, Mm^Xm, Mm, Mm, Mm, Mm^Xm, Mm^Xm, Mm^Xm, Chr, Hh, Rb^Efm, Rb^Efm, Hh, Mm^Xm, Mm^Xm, Mm, Mm, Mm, Mm, Mm^Xm
Mm^Xm, Mm, Mm, Mm, Mm, Mm^Xm, Mm^Xm, Mm, Mm, Mm, Mm, Mm, Mm, Mm, Mm, Mm, Mm, Chr, 2 Khr, Chr, Rb^Es, Hh, Mm^Xm, Mm^Xm, Mm, Mm^Xm, Mm, Mm, Mm, Mm
Mm^Xm, Mm^Xm, Mm^Xm, Mm, Mm, Mm^Xm, Mm, Mm, Mm, Mm, Mm, Mm, Mm, Mm, Mm^Xm, Mm, Mm^Xm, Chr, Chr, Chr, Re^Dr, Hh, Mm^Xm, Mm, Mm, Mm, Mm, Mm, Mm, Mm^Xm
Mm^Xm, Mm^Xm, Mm, Mm, Mm, Mm, Mm, Mm, Mm, Mm, Mm, Mm, Hh^Fdw, Hh^Fdw, Mm, Mm^Xm, Mm^Xm, Mm^Xm, Mm^Xm, Hh, Re^Es, Hh^Vhcr, Hh^Dr, Mm^Xm, Mm^Xm, Mm, Mm, Mm, Mm^Xm, Mm^Xm
Mm, Mm, Mm, Mm, Mm, Mm, Mm, Mm, Hh, Mm, Mm, Mm, Hh^Fms, Mm, Mm, Mm, Mm, Mm, Mm^Xm, Hh, Hh^Em, Re^Efm, Hh^Dr, Mm, Mm, Mm^Xm, Mm^Xm, Mm^Xm, Mm, Mm^Xm
Mm^Xm, Mm, Mm, Mm, Mm, Mm^Xm, Mm^Xm, Mm, Mm, Hh, Hh^Fms, Hh^Fms, Mm, Hh, Hh^Fms, Mm, Hh, Mm, Mm^Xm, Mm^Xm, Hh^Emf, Re^Efm, Hh, Hh^Fmw, Hh, Mm, Mm, Mm, Mm, Mm
Mm, Mm, Mm, Mm, Mm, Mm, Mm, Mm, Mm, Mm, Hh^Fdw, Hh^Fdw, Hh^Em, Mm, Mm, Hh^Fms, Mm, Mm^Xm, Mm^Xm, Mm^Xm, Hh^Em, Rb^Efm, Hh, Hh^Fmw, Hh, Mm, Mm, Mm, Mm^Xm, Mm^Xm
Mm^Xm, Mm, Mm, Mm, Mm, Mm, Mm, Mm, Mm, Mm, Hh^Fdw, Hh^Ve, Rb, Hh^Emf, Hh^Em, Hh^Fdw, Hh^Fdw, Mm, Mm, Mm^Xm, Hh, Rb, Hh^Vhcr, Hh, Mm, Mm, Mm, Mm^Xm, Mm^Xm, Mm^Xm
Mm^Xm, Mm^Xm, Mm^Xm, Mm, Mm, Hh, Hh, Mm, Mm, Hh, Mm, Hh, Hh, Re, Re^Efm, Hh, Hh^Vhh, Hh^Fdw, Hh, Mm^Xm, Hh, Rb, Hh, Hh^Fmw, Hh^Fmw, Mm, Mm, Mm, Mm, Mm^Xm
Mm, Mm, Mm, Mm, Mm, Mm, Mm, Mm, Mm, Mm, Mm, Mm, Mm, Hh, Hh, Re^Efm, Hh^Dr, Hh, Rb^Efm, Hh, Re, Re, Hh, Hh^Fmw, Mm, Mm, Mm, Mm, Mm^Xm, Mm^Xm
Mm^Xm, Mm, Mm, Mm, Mm, Mm, Mm, Mm, Mm, Mm, Mm, Mm, Hh^Fdw, Hh, Re^Dr, Re^Efm, Re^Es, Hh^Dr, Rb^Es, Re, Hh, Rb^Efm, Hh, Mm, Mm, Mm, Mm, Mm, Mm^Xm, Mm^Xm
Mm^Xm, Mm^Xm, Mm, Mm, Mm^Xm, Mm^Xm, Mm, Mm, Hh, Hh, Hh, Mm, Hh^Ve, Hh, Re^Efm, Hh, Hh, Rb^Es, Hh, Hh, Hh^Fdw, Hh, Mm, Mm, Mm, Mm, Mm, Mm, Mm^Xm, Mm^Xm
Mm, Mm, Hh, Hh, Hh, Mm^Xm, Hh^Ve, Hh, Re^Efm, Re^Dr, Re^Es, Hh, Rb^Efm, Rb^Efm, Hh^Em, Re, Hh^Em, Hh^Ve, Hh^Fdw, Mm, Mm, Mm, Mm, Mm, Mm, Mm, Mm, Mm^Xm, Mm^Xm, Mm^Xm
Hh^Fdw, Hh, Chr, Chr, Chr, Hh, Re^Efm, Rb^Efm, Hh^Em, Hh, Hh, Rb, Hh, Hh, Mm, Hh^Emf, Hh^Fdw, Hh^Fdw, Mm, Mm, Mm, Mm, Hh, Mm, Hh, Mm, Hh^Fms, Mm^Ii, Mm, Mm^Xm
Hh^Fdw, Hh^Em, Chr, Khr, Re^Efm, Re^Ecf, Chr, Hh^Em, Hh^Emf, Mm, Mm, Hh, Hh^Fms, Mm, Mm, Mm, Mm, Hh^Fdw, Mm, Mm, Mm, Mm, Mm, Hh, Mm, Mm, Mm, Hh^Fetd, Mm^Xm, Mm^Xm
Mm^Xm, Hh^Emf, Hh, Chr, Rb, Hh, 1 Khr, Chr, Hh^Em, Hh^Fds, Hh, Mm, Hh^Fms, Mm, Mm, Mm, Mm, Mm, Hh, Mm, Mm, Mm, Hh^Fdw, Hh^Fdw, Mm, Mm, Mm, Mm, Mm, Mm^Xm
Hh, Hh^Em, Rb^Efm, Rb^Efm, Hh, Chr, Chr, Chr, Hh, Hh^Fds, Mm, Mm, Mm, Hh^Fms, Hh^Fms, Mm, Hh^Fms, Hh, Mm, Mm, Mm, Hh^Fdw, Hh^Fdw, Hh, Mm, Mm, Mm, Mm, Mm^Xm, Mm^Xm
Re, Re^Efm, Hh, Hh, Mm^Xm, Hh, Hh, Hh, Mm, Hh^Fds, Hh, Mm, Mm, Mm, Mm, Hh, Mm, Hh^Fms, Hh^Fms, Mm, Mm, Mm, Mm, Mm, Mm, Mm, Mm, Mm, Mm, Mm
Hh, Hh, Mm^Xm, Mm^Xm, Mm^Xm, Mm^Xm, Mm^Xm, Mm^Xm, Mm^Xm, Mm, Mm, Hh^Fds, Hh^Fds, Mm, Hh^Fms, Hh^Fms, Hh^Fms, Mm, Mm, Hh, Hh, Mm, Hh^Fdw, Hh^Fdw, Hh^Fdw, Mm, Mm, Mm, Hh^Fdw, Hh^Fdw
