Gs, Gs, Aa^Esa, Aa^Esa, Aa, Aa, Aa, Aa, Aa, Aa, Aa, Aa, Gd, Aa, Aa, Aa, Gs, Gg, Md, Gg, Gg, Gg, Gs, Aa, Aa, Aa, Aa, Aa, Gs, Gg, Gs, Aa, Aa, Aa, Aa, Aa, Aa^Esa, Gs, Gs, Gd
Gs, Gs, Gg^Efm, Aa^Esa, Gg^Efm, Aa^Esa, Aa^Esa, Aa, Aa, Aa, Hhd, Aa, Aa^Fda, Gd, Aa, Gs, Hh, Gs, Md, Md, Gs, Gs, Gs, Aa, Aa, Gd^Efm, Gd^Efm, Aa, Gd, Gd, Gs^Fp, Gs, Gs, Gd, Aa, Aa, Aa^Esa, Aa^Esa, Gd, Gd
Re, Gs, Gs, Gg^Efm, Gg, Aa, Hh^Em, Hhd, Aa, Aa, Aa, Aa^Fda, Md, Gd, Aa, Gs, Gs, Gs, Hh^Dr, Hhd^Em, Hhd, Md, Hh, Gs, Aa, Gd^Efm, Aa, Gd, Gd, Gs^Fp, Rr^Ii, Gs^Fp, Gd, Gd, Aa, Gs^Efm, Gs^Vh, Gs, Re^Es, Re^Es
Gs, Re, Re, Gll, Gs^Efm, Gs^Efm, Hh^Dr, Aa, Hh, Hh, Hhd^Dr, Hhd, Md, Gg^Efm, Gg^Efm, Aa, Aa, Hh^Em, Gll, Gll, Gll, Aa, Aa^Esa, Aa, Aa, Gd^Em, Aa, Gs, Gs, Gs^Fp, Gs^Fp, Gs^Fp, Gd, Aa, Re^Es, Re, Re, Re, Re^Es, Aa^Esa
Gs, Re, Re, Gll, Gg^Efm, Gs^Efm, Aa^Esa, Aa, Aa^Fda, Mm, Mm, Hhd^Em, Aa^Fda, Gg^Efm, Aa, Aa, Aa^Esa, Aa^Esa, Aa^Esa, Hhd, Gs, Aa, Aa, Aa^Esa, Aa, Aa, Aa, Gs^Efm, Gg^Efm, Gs, Gs^Em, Gs^Emf, Re, Re, Gd^Em, Gd, Gd, Gd, Aa^Esa, Aa^Esa
Gg, Gs, Re, Gll, Gg, Aa, Gd, Aa, Hh, Hh^Em, Gd, Mm, Aa^Fda, Aa, Aa^Esa, Aa^Esa, Hhd^Dr, Hhd, Gs, Gs, Gs, Gd^Edb, Gll, Aa^Esa, Aa, Gs, Gs, Gs, Gg^Efm, Gs, Re^Es, Re, Ds, Gd, Aa^Esa, Aa, Aa, Aa, Aa, Aa
Gg, Gs^Efm, Re^Es, Re, Gs^Vo, Gg, Gg, Gd, Gd, Gd, Aa, Aa^Fda, Aa, Aa, Md, Hhd^Dr, Md, Gg, Co, Co, Co, Gd^Edb, Gs^Ecf, Gs^Efm, Gd, Gs, Gd, Gg, Gll^Efm, Re, Gs, Ds, Aa, Gd, Aa^Esa, Aa, Gs^Fp, Aa, Aa, Aa
Gg, Gs, Gll, Re, Re, Gs, Gs, Gg, Gg, Gg^Efm, Gd^Efm, Aa, Gd, Aa, Md, Gll^Efm, Gg^Efm, Gg^Vo, Co, 3 Ko, Co, Gd^Edb, Gs^Efm, Gs, Gd, Gd, Re, Gd^Vh, Re, Re, Gd^Efm, Wwr, Wo, Aa, Aa^Esa, Gs^Fp, Gs^Fp, Gg^Ve, Gs^Fp, Gs^Fp
Gg, Gs, Gg, Gll, Gll, Re, Re, Gs, Gd, Gg, Gg^Efm, Aa, Gs, Hhd, Gg^Efm, Gll, Aa, Aa, Aa, Co, Aa^Fda, Gd, Gd^Edb, Gd, Ds, Ds, Re^Es, Re^Es, Gd, Aa, Gd, Ds, Ds, Aa^Esa, Gs^Fp, Gs^Fp, Gs^Fp, Gs^Fp, Gs^Fp, Gg
Gg, Gs, Gs, Gg^Efm, Gg, Gll, Gs^Vo, Re, Gd, Gg, Gg, Gg, Gg, Gd, Gg, Gg, Gd^Efm, Gs^Efm, Gs^Efm, Aa, Aa, Aa, Wwr, Wwr, Ds, Re^Es, Gs, Gs, Gd, Aa, Aa, Gd, Aa, Aa, Gs^Fp, Gs^Fp, Gs^Fp, Gs^Fp, Gs^Fp, Gg
Gg, Gg^Efm, Gs, Gg^Efm, Gg^Efm, Gg, Gg, Re, Re^Es, Gd, Gd, Gs, Gd^Edb, Gg, Gs^Em, Gg, Gg, Gd^Dr, Gg, Gd, Gg, Wo, Ds, Ds, Re, Re, Gd, Gd, Aa, Aa, Gd^Edb, Aa, Gd, Aa, Gs^Fp, Gs^Fp, Gs^Fp, Gs, Gs^Fp, Gs^Fp
Gg, Gg, Gs, Gg, Gg, Gg, Gd, Gs^Em, Gs, Re^Es, Re, Re^Es, Re^Em, Gd, Gd^Edb, Gs, Gg, Gg, Gs^Edb, Gs, Gs^Edb, Gs, Re, Re, Gg, Gd, Aa^Esa, Aa^Esa, Aa, Aa, Gd^Em, Gd, Gs^Fp, Gd^Edb, Gs^Fp, Gs^Fp, Gs, Gs^Fp, Gs^Fp, Gs^Fp
Gg, Gs, Gd, Gs, Gs, Gg, Gd, Gs, Gg^Es, Gd, Gll, Gll^Em, Gs, Re, Re, Re, Re, Gs^Edb, Re^Es, Re, Re, Re^Es, Gll, Gll^Efm, Gg^Emf, Gd, Aa, Aa, Gd^Edb, Gd^Edb, Gd^Emf, Gs^Emf, Cv, Gs^Fp, Gg^Ve, Gs^Fp, Gs^Fp, Gs^Fp, Gs, Gs
Gg, Gs, Gd, Gs^Fp, Gd^Em, Gd, Gg, Gs, Gs, Gd^Es, Gg, Gll^Em, Gg^Em, Gll, Gll, Gll^Fp, Re, Re, Re, Gll^Fp, Re, Gs, Gg, Gg^Efm, Gg, Gd, Aa, Gd^Edb, Gs^Fp, Gs^Fp, Gs^Fp, Cv, 2 Kv, Cv, Gs, Gs^Fp, Gs^Fp, Gs^Efm, Gs^Efm, Gs^Fp
Gs, Gs^Em, Gd, Gd^Em, Gd, Gd, Gg, Gg^Ve, Gs, Gd, Gs, Gg, Gg, Gg, Gd, Gd, Gd, Gs, Gs, Re, Re, Gs, Gll, Gg, Aa, Aa, Aa, Aa^Esa, Gs^Efm, Gg^Ve, Gs^Fp, Cv, Cv, Cv, Gs^Efm, Gs^Fp, Gs^Fp, Gs^Fp, Gs, Gg
Gg, Gg, Gg, Gg, Gg^Efm, Gg^Efm, Gg^Efm, Gg^Efm, Gg, Gs, Gg^Ve, Gs, Gg, Gg, Gd, Gd^Ecf, Gd, Gg^Efm, Gll^Efm, Gll^Efm, Re, Gll, Gll, Gg^Efm, Aa, Aa, Aa^Esa, Aa^Esa, Gs^Efm, Gs^Fp, Gs^Fp, Gs^Fp, Gs^Fp, Gs^Fp, Gs, Gs^Fp, Gs^Fp, Gs^Fp, Gs^Fp, Gs^Fp
Gg, Gg^Efm, Gg, Gll^Efm, Gg, Gg, Gs, Gs, Gd, Gg, Gg, Gg, Gd^Em, Gg, Gg, Gd, Gg, Gg, Gs, Gg, Gs^Ve, Re, Re, Aa, Gd, Aa, Aa^Esa, Gs^Efm, Gs^Fp, Gs^Fp, Gs^Fp, Gs^Fp, Gg^Ve, Gs^Fp, Gs^Fp, Gs^Fp, Gg, Gs^Fp, Gs^Fp, Gg
Gg, Gg, Gg, Gg^Em, Gll^Efm, Gs, Gd^Em, Gd, Wwr, Gd^Em, Gd, Gg^Em, Gg, Gg^Em, Gs, Gg, Gg^Efm, Gg, Gg, Gs, Gg, Re^Es, Re^Es, Re, Gd^Em, Gd, Gd, Gd^Em, Gs^Fp, Gs^Edb, Gs^Fp, Gs^Fp, Gs^Fp, Gs^Fp, Gs, Gs^Fp, Gs^Fp, Gs^Fp, Gs^Fp, Gs^Fp
Gd, Gg, Gs, Gs, Gd, Gs, Gg^Ve, Ww^Bw|, Wo, Wwr, Gd, Gg^Em, Gs^Em, Gg, Gs^Vh, Gs, Gll^Efm, Gg, Ss, Gg, Gg, Gd, Gd, Re^Es, Re, Gs, Gs, Gs^Fp, Gs^Fp, Gs^Edb, Gs^Fp, Gs^Fp, Gs^Fp, Gs^Fp, Gg, Gs^Fp, Gs^Fp, Gs^Fp, Gs^Fp, Gs^Fp
Gg, Gd, Gs, Gs, Gd, Gg, Ww^Bw\, Ww^Bw|, Ww, Ww^Ewl, Ww^Ewl, Ds, Ds, Gs, Gg, Gg, Gs, Gg^Efm, Gg^Efm, Ss, Gg, Gg, Gg^Es, Gd, Gd, Re, Re, Gg, Gs^Fp, Gs^Fp, Gs, Gs^Fp, Gs, Gs^Fp, Gs^Fp, Gs^Fp, Gs^Fp, Gs^Fp, Gs^Fp, Gs^Fp
Gg, Gd, Gs^Vh, Gd, Ss, Ww, Ss, Sm, Sm, Sm^Bw\, Ss, Wwr, Ds, Gd, Gd^Es, Gg, Ww^Ewl, Ss, Ww, Gs, Gs, Gg^Es, Gs, Gd, Gd^Ecf, Gd, Re, Gg^Ve, Gs^Fp, Gs^Fp, Gg, Gs^Fp, Gs^Fp, Gg, Gs^Fp, Gg, Gs^Fp, Gs, Gs, Gg
Gg, Gs, Gs, Ss, Ss, Ss, Ss, Ss, Ss, Ss, Ss, Wwr, Ds, Gs, Gd^Es, Gg, Ss, Wwr, Ss, Gs, Gll, Gs^Es, Gg^Es, Gs, Gll, Gs, Gll, Re, Gs^Fp, Gs^Fp, Gs^Fp, Gs^Fp, Gs^Fp, Gs^Fp, Gs, Gg, Gs^Fp, Gg, Gs^Fp, Gs^Fp
Gg, Gg, Gs, Ss, Ss, Ss, Ss, Ss, Ss, Ss, Ss, Ww, Wwr, Gs^Es, Gs, Gg, Gg^Efm, Ss, Re, Sm, Re, Gd, Gg, Gs, Gs, Gll, Gs^Fp, Gs^Fp, Re, Gs^Fp, Gs^Fp, Gs^Fp, Gs^Fp, Gs^Fp, Gs, Gs^Fp, Gs^Fp, Gs^Fp, Gs^Fp, Gg
Gs, Gd, Gd, Ss, Ss, Ss, Ss, 8 Khs, Ss, Ss, Ss, Ss, Gd, Gd, Gg, Gg, Re, Re, Sm, Re, Sm, Gg^Vh, Gg, Gg, Gs^Fp, Gs, Gs^Fp, Re, Gs^Fp, Re, Gs^Fp, Gs^Fp, Gs^Fp, Gs, Gs^Efm, Gs, Gs^Fp, Gs^Fp, Gs^Fp, Gg
Gg, Gs, Gd, Ww^Ewl, Sm, Ss, Ss, Ww^Bw|, Gll, Ss, Ss, Ss, Gs, Gd, Gg, Ds, Re, Ss, Wwr, Sm, Ss, Gg, Gg, Gg, Gs, Gs, Gs^Fp, Gs^Fp, Re, Gs^Fp, Gs^Fp, Re, Gs^Fp, Gs^Fp, Gs^Fp, Gs^Fp, Gs^Fp, Gs^Fp, Gs^Fp, Gg
Gg, Gg, Gd^Es, Wwr, Ww, Ss, Ss, Gll^Es, Gs, Ss, Gs, Gll, Gll, Gg, Gg, Ww^Ewl, Ss, Ss, Ds, Ss, Gg, Gg, Gg^Efm, Gg, Gll, Gs^Fp, Gg, Gs^Fp, Gs^Fp, Gs^Fp, Re, Gs^Fp, Gs^Fp, Gs^Fp, Gg, Gs^Fp, Gs^Fp, Gg, Gs^Fp, Gs^Fp
Gg, Gg^Efm, Gg^Efm, Gd^Es, Gd^Es, Gll, Gg, Gll, Gs, Gs, Gll, Gll, Gg, Gg, Gg, Wwr, Wwr, Ss, Ds, Gg, Gg^Efm, Gg^Efm, Gll, Gll, Gs^Fp, Gs^Fp, Gs^Fp, Gs^Fp, Gs^Fp, Gs^Fp, Gs^Fp, Re, Gs^Fp, Gs^Fp, Gs^Fp, Gs^Fp, Gs^Fp, Gs^Fp, Gg^Efm, Gs^Fp
Gg, Gg^Efm, Gg, Gd, Gg, Gg, Gg^Efm, Gg^Efm, Gll^Em, Gg^Efm, Gg, Gg, Gg, Gg, Gll, Gg, Gg, Ww, Gg, Gg, Gg^Efm, Gs, Gll, Gll, Gs^Fp, Gs^Fp, Gs^Fp, Gs^Fp, Gg^Ve, Gs^Fp, Gs^Fp, Gs^Fp, Gs^Fp, Re, Gs^Fp, Gs^Fp, Gs^Fp, Gs^Fp, Gg, Gg
Gg, Gg, Gg, Gg, Gg^Efm, Gg, Gg, Gd, Gg, Gd^Efm, Gg, Gg, Gd, Gll, 1 Ke, Gll, Gg, Gd, Gg, Gg, Gs, Gs^Em, Gs^Em, Gs^Fp, Gs^Fp, Gs^Fp, Gs^Fp, Gs^Fp, Gs^Fp, Gs^Fp, Gs^Fp, Re, Re, Gs^Fp, Gs^Fp, Gs^Fp, Gg, Gs^Fp, Gs^Fp, Gs^Fp
Gs, Gs, Gg, Gg, Gg, Gg, Gs, Gg, Gs, Gg, Gd, Gd^Em, Gll, Gd^Em, Gll, Gs^Em, Gs, Gd, Gs, Gs^Em, Gs, Gs^Em, Gs^Fp, Gs^Fp, Gs, Gs, Gs^Fp, Gs^Fp, Gs^Fp, Gs^Fp, Gs^Fp, Gs^Fp, Gs^Fp, Gs^Fp, Gs^Fp, Gs^Fp, Re, Gs^Fp, Gs^Fp, Gg
Gll, Gd, Gs, Gs, Gd, Gd, Gd, Gs, Gll, Gs, Gll, Gll, Gll, Gs, Gs, Gs, Gd, Gd, Gs, Gs^Em, Gs, Gs^Em, Gs^Fp, Gs^Fp, Gs^Fp, Gs^Fp, Gs, Gs^Fp, Gs^Fp, Gs^Fp, Gs^Fp, Gs^Fp, Gs^Fp, Re, Re, Gs^Fp, Gs^Fp, Gs^Fp, Gs^Fp, Gs^Fp
Gll, Gll, Gs, Gs, Gd, Gd, Gs, Gs, Gs, Gll, Gs, Gs, Gs, Gs, Gg, Gs, Gll, Gll, Gd, Gd, Gd, Gs^Fp, Gs^Fp, Gs, Gs, Gs^Fp, Gg, Gg, Gs^Fp, Gs^Fp, Gs^Fp, Gg, Gg, Gs^Fp, Re, Gg, Re, Gs^Fp, Gg, Re
