Ms, Ms, Ms, Ms, Md, Md, Md, Ms, Ms^Xm, Ms, Md, Md, Md, Ms, Ms, Ms, Ms, Md, Md^Xm, Ms^Xm, Ms^Xm, Ms^Xm, Ms^Xm, Ms^Xm, Md, Md, Md, Md, Md, Ms, Ms, Ms, Md, Ms^Xm, Ms^Xm, Ms, Md, Md, Md, Ms, Ms, Ms, Md, Md, Md, Ms, Ms, Ms, Ms, Ms, Ms^Xm, Ms, Ms, Ms, Ms, Ms, Ms, Ms, Ms, Ms, Ms, Ms, Rr, Ms, Ms^Xm, Ms, Ms^Xm, Ms
Ms, Ms^Xm, Ms, Ms, Ms, Md, Ms, Ms^Xm, Md, Md, Md, Md, Md, Md, Md, Ms, Ms^Xm, Md, Md, Md^Xm, Md, Ms^Xm, Md, Md^Xm, Md^Xm, Md, Md, Md, Md, Md, Md, Md^Xm, Md^Xm, Md, Md, Ms^Xm, Ms^Xm, Md, Md, Md, Md, Ms, Ms, Md, Md, Md, Md, Ms, Ms, Ms, Ms, Ms, Ms, Ms, Ms, Ms^Xm, Ms, Ms, Ms, Ms, Ms, Ms, Rr, Ms, Ms^Xm, Ms, Ms, Ms
Ms, Ms, Ms, Ms, Ms, Ms^Xm, Ms, Ms^Xm, Ms^Xm, Md, Md, Md, Md, Md, Ms, Ms^Xm, Ms, Ms, Ms, Md, Md, Md, Ms^Xm, Md, Md, Md, Md, Md, Md, Md, Md, Md, Md, Md, Md, Md, Md, Md, Md, Md, Md, Ms, Ms, Md, Md, Md, Ms, Ms^Xm, Ms, Ms, Hh, Ms, Ms, Ms, Hh, Ms, Rr, Ms, Ms, Ms, Ms, Ms, Re, Ms^Xm, Ms, Ms, Ms, Ms
Ms, Ms, Ms, Ms^Xm, Ms, Ms, Ha, Ms, Ms, Ha, Ha, Md, Ha, Ms, Ha^Esa, Ms, Ms, Ha^Vhha, Md, Md, Md, Ms^Xm, Ms^Xm, Ms^Xm, Ms, Md, Md, Md, Md, Md, Md, Md, Md, Md, Md, Md, Md, Md, Md, Md, Md, Md, Md, Md, Md, Md, Md, Ms, Ms, Hh^Vhh, Ms, Hh^Vhh, Hhd^Fdw, Rr, Ms, Hh, Ms, Aa, Re^Es, Ms, Aa^Fdw, Re, Ms^Xm, Ms, Ms, Ms, Ms, Ms
Ms, Ms, Ha^Esa, Ms, Ha^Esa, Ha^Esa, Aa, Aa^Esa, Ms, Ms, Hh^Em, Ha, Hh^Em, Ha^Esa, Hh^Fp, Ms, Md, Md, Md, Md, Ms, Ms, Ms, Ms, Ms, Md, Md, Md^Xm, Md^Xm, Md, Md, Md, Md, Ms^Xm, Ms^Xm, Md, Md, Md, Md, Md, Md, Md, Md, Md, Md, Md, Md, Md, Ms, Hh, Ms, Ms, Md^Xm, Ms^Xm, Ms^Xm, Ms^Xm, Md, Aa, Ms, Aa, Md^Xm, Ms, Ms, Ms, Ms, Ms, Ms^Xm, Ms
Ha, Ha, Ha^Esa, Ha^Esa, Aa, Aa, Ms, Ms, Hhd, Hh, Hhd^Fp, Hh^Emf, Hh, Hh^Esa, Hh^Fp, Hh^Fp, Hh^Fp, Md, Hhd^Fp, Ms^Xm, Ha, Ms, Ha, Ms, Ms, Ms, Ms^Xm, Md, Md, Md, Md, Md, Md, Md, Ms^Xm, Ms, Ms, Md, Hh^Vhh, Ms^Xm, Ms, Md, Md, Md, Md, Md, Ms^Xm, Ms, Re^Es, Aa, Hhd, Md, Md, Md^Xm, Md, Md, Md, Md, Md, Md, Md, Md, Md, Ms, Ms, Ms, Ms, Ms
Ha, Ha, Ha, Ha, Aa, Ms, Hhd^Fp, Hhd^Fp, Hh^Fp, Hhd^Fp, Hh^Fp, Hh, Hh, Hh, Hh^Emf, Hh, Hh^Em, Hhd^Fp, Hh, Hhd^Fp, Hhd^Fp, Ha^Esa, Hh^Esa, Ha^Esa, Ha, Ms, Ms, Ms^Xm, Ms^Xm, Md, Md, Md, Ms, Ms, Ms, Ms, Ms, Ms, Ms, Ms^Xm, Ms, Ms, Ms^Xm, Md, Ms^Xm, Ms^Xm, Ms, Ms, Re, Ha^Vhha, Ms, Md, Md, Md, Md, Md, Ms, Md, Md, Md, Ms, Md, Md^Xm, Md, Hh^Vhh, Ms, Md, Ms
Ha^Esa, Ha^Esa, Ha, Ha, Ha, Ms^Xm, Md^Xm, Hhd^Fp, Hhd^Fp, Hh^Fdw, Hh^Fdw, Hh^Fdw, Hh^Fdw, Hh^Emf, Hh^Esa, Hh, Hh, Hh, Hhd, Hh^Fdw, Hh^Fdw, Hhd^Fp, Hh^Fp, Hh^Fp, Hh^Fp, Hh^Fp, Hhd^Fp, Ms, Hhd^Fp, Hh^Fp, Hhd^Dr, Ha, Ha, Ha^Fdw, Ha, Ha, Ha, Ha, Ha^Fdw, Ms, Ms, Ms, Ms, Ms^Xm, Ms, Ms^Xm, Ms, Ms, Aa, Hhd^Fdw, Ms, Md, Md, Md, Md, Ms, Ms, Ms, Ms, Ms, Md, Md, Md^Xm, Ms, Ms, Md, Md, Md
Ha^Esa, Ha^Esa, Ha, Ha^Esa, Ha, Md, Md, Md^Xm, Md, Hhd^Fp, Hhd^Fp, Hh^Fdw, Hh, Hh^Em, Hh^Esa, Hh, Hh^Fp, Hh, Hh^Fp, Hh, Hh, Hh^Fdw, Hh, Hh^Fp, Hh^Fp, Hh, Hh^Em, Hhd^Fp, Hh^Fp, Hh, Hh^Em, Hh^Esa, Hh^Esa, Ha^Esa, Hhd^Fp, Hh^Fp, Hh^Fp, Hhd, Hh, Ha^Fdw, Ha^Esa, Ha, Ms, Ms, Ms, Ms, Ms, Ms, Aa^Esa, Ms, Md, Md, Md^Xm, Md, Md, Md, Md, Ms, Ms, Ms, Md, Md^Xm, Md, Md, Md^Xm, Ms, Md, Ms
Aa^Esa, Aa, Aa, Ha^Esa, Ha, Ha, Ha, Md, Md, Md, Hh^Fp, Hh, Hh^Esa, Hh^Esa, Ha^Esa, Ha^Fdw, Ha, Hh^Fp, Hh, Hh^Fp, Hh^Esa, Hhd^Fdw, Hh^Fdw, Hh, Hh, Hh^Em, Hh^Emf, Hh, Hh, Hh, Hh, Hh, Hh^Fp, Hh^Fp, Hh, Hh^Fp, Hh, Hhd^Fp, Hhd^Fp, Hh, Hh^Emf, Ha^Esa, Ha, Ha^Fdw, Ha^Fdw, Ms, Ha, Ha^Esa, Re, Ms, Md, Md, Md, Md, Md, Md, Md, Md, Md, Md, Md, Md, Ms, Md, Md, Md^Xm, Md, Md
Aa, Aa, Aa, Aa^Esa, Aa, Ha, Ha, Hh, Ha, Hh^Fp, Ha^Fdw, Ha, Ha^Esa, Ha^Esa, Chr, Ha, Ha, Ha^Esa, Aa^Esa, Hh^Esa, Gll, Hh, Gs, Hh, Hh, Hh^Em, Hh, Hh, Hhd^Fdw, Hhd^Fdw, Hh^Esa, Hh^Esa, Hh^Esa, Hh, Hh^Fp, Hh, Gd, Hh, Hh, Hh, Hh^Fdw, Hh^Em, Hhd^Fdw, Hhd^Fdw, Ha, Ha, Ha^Esa, Ha^Esa, Re^Es, Md, Md, Md, Ms, Md, Ms, Ms, Md, Md, Md, Md, Md, Ms, Md, Md^Xm, Md^Xm, Md, Md, Md
Gs, Gd, Gd, Aa^Esa, Aa^Fdw, Aa, Aa, Ha, Ha, Ha^Fdw, Ha, Aa, Aa, Aa, Chr, Chr, Chr, Gd^Fdw, Aa, Gd, Gd, Gs, Gs, Gd, Gll, Gll, Gll, Gs^Em, Gs^Fdw, Hh^Fdw, Gs^Esa, Hh, Gd^Edt, Hh, Gd^Edt, Gd, Gs^Edt, Gd, Hh, Hh^Em, Hh^Fdw, Hhd^Fdw, Hhd^Fp, Hh^Fp, Ha, Ha, Ha^Esa, Ha, Ha^Fdw, Re^Es, Ms, Aa, Ms, Md, Md^Xm, Md, Md, Md, Md, Md, Md, Md, Md, Md, Md, Md, Md, Md
Gs, Gg^Efm, Gd^Fdw, Gll, Gs^Edt, Aa^Esa, Aa^Esa, Aa, Aa, Aa, Aa, Aa, Gd^Edt, Aa, Chr, 1 Khr, Chr, Chr, Chr^Em, Gd^Ecf, Gd^Em, Gll, Gs, Gg^Efm, Gg^Efm, Gll^Efm, Gs, Gll^Em, Gs^Em, Gs, Gs^Edt, Gs^Edt, Gd, Gd^Edt, Gs, Gs^Edt, Gs, Gs^Edt, Gs, Hh^Em, Hh, Hh^Emf, Hh^Fp, Ms, Ms, Ha, Ha, Ha^Fdw, Ha^Fp, Re^Es, Rb, Aa, Aa, Md, Md, Md, Ms, Md, Md, Md, Ms, Md, Md, Ms, Ms^Xm, Md, Ms, Md
Gs, Gd, Gll, Gll^Edt, Gs, Gs^Efm, Aa, Aa^Esa, Aa, Aa^Fdw, Gd^Edt, Gd^Edt, Gs^Edt, Gd^Edt, Gd^Edt, Chr, Gd^Vhr, Chr, Gd, Gd^Em, Gs, Gs^Edt, Gs^Edt, Gs, Gs, Gs, Gs, Gs, Gd, Gd, Gg^Efm, Gg^Efm, Gg^Efm, Gs, Gg^Efm, Gg^Edt, Gs, Gs, Aa, Gs, Hh, Hh, Hh, Hhd, Hhd, Ms, Ms, Ha, Ha, Ha^Fdw, Rb, Ai, Ai, Aa, Aa, Md, Ha, Ha^Fdw, Ha, Ha^Esa, Md, Md, Ms, Ms, Ms, Ms, Ms^Xm, Ms
Gll, Gll, Gs^Esa, Gs^Esa, Gg, Gs^Efm, Gs^Efm, Aa^Esa, Gs^Efm, Gll^Fp, Gll^Fp, Gll, Gs, Aa, Aa^Esa, Chr, Aa, Gd, Gs, Gs^Edt, Gll^Edt, Gs^Edt, Gg^Edt, Gll, Gll, Gs, Gd^Edb, Gd^Edb, Gs, Gll, Gll, Gs, Gs, Gg^Fdw, Gs, Gs, Gs^Edb, Gd, Gd, Gd, Ha, Hh, Ha, Ha, Ha, Ms^Xm, Ha^Esa, Ha, Ha^Esa, Ha^Esa, Re, Ai, Ai, Aa, Aa, Ms, Ha^Esa, Ha, Ha, Ha, Ha, Ha, Re, Re, Re, Ms, Ms, Ms
Gs, Gs, Gll^Esa, Gs, Gd, Gg, Gg, Gs^Efm, Gg, Gll^Fdw, Gs, Gs^Edt, Gs^Edt, Gs^Esa, Aa^Esa, Aa^Esa, Gs, Aa^Fdw, Gs^Fdw, Gll, Gg, Gg, Gg^Efm, Gll, Gs, Gll, Gd, Gs, Gs, Gll, Gll, Gs, Gd^Vhr, Gs, Gs, Gs^Edb, Gs^Edb, Gs, Gll, Gd, Wwf, Ha^Fdw, Ms, Ms, Ms, Ms^Xm, Aa, Ha^Fdw, Ha, Aa, Re, Re^Es, Re^Es, Ai, Ai, Aa^Esa, Aa^Esa, Aa^Esa, Re^Esa, Ha^Fdw, Ha^Fp, Ha^Fdw, Gs, Gs, Gs^Fdw, Re, Re, Hh
Gs, Gs, Gs, Gs, Gll^Dr, Gd, Gs, Gg, Gg, Gg, Gg^Efm, Gs, Gs, Gs, Gg, Gg^Esa, Gg, Gs, Gs, Gs, Gs, Gg^Efm, Gd, Gg^Efm, Gs^Edb, Gd, Gd, Aa, Gs, Gll, Gs, Gs, Gs, Gs, Gs^Fdw, Gll, Gll^Fdw, Gll, Wo, Gll, Wwf, Wwf, Wwf, Wwr, Wwr, Wwr, Wwr, Aa, Aa, Aa, Re, Gs^Fdw, Re^Es, Ai, Ai, Ai^Esa, Ai, Ai, Re, Ha^Esa, Ha, Ha^Esa, Ha^Esa, Gd, Aa, Gd, Gs, Hh
Gd, Gd, Re, Re, Re, Gd, Gs, Gs, Gg^Efm, Aa, Aa, Aa, Aa, Gs, Gg^Efm, Gg^Efm, Gg^Efm, Gg, Gs, Gs, Aa, Gg^Efm, Gd, Gd^Esa, Gd^Edb, Gd^Ecf, Gd, Aa, Aa, Gll, Gll, Gll, Gll, Gs, Gs^Fdw, Gs^Fdw, Ww^Ewl, Ww, Ww, Wwf, Wo, Wo, Wo, Wwf, Wo, Wo, Wwf, Wwr, Rb, Re, Gd, Gd, Re, Ai, Ai, Ai, Re, Re, Ms, Ms, Ha, Ha, Ha, Gd^Esa, Ms, Aa, Gd, Gs
Gd, Re, Gll, Gd, Gd, Re^Es, Re^Es, Gs, Gd, Gd, Gd, Gd, Gd, Aa^Esa, Aa, Aa, Gg^Efm, Gs, Gs^Esa, Gs^Edt, Aa, Aa, Aa, Gd, Gd^Esa, Gd, Aa, Aa, Aa^Esa, Gs, Gs, Gs, Gg, Gll^Fp, Gs, Ww, Gs, Gll, Gll, Ww^Ewf, Ww, Wo, Gll, Wo, Ww, Wwf, Gd^Fdw, Re, Re, Gs, Gs, Gs, Gs, Re, Re, Re, Ms, Ms, Hhd, Ms, Ms, Ha, Gd, Gd, Ms, Aa, Aa, Gs
Re, Re, Gd, Hh, Hh, Gd^Fdw, Gd, Re, Re, Gd, Rb, Gd, Gll, Gd, Gd, Gd, Gll, Gs, Gs, Gs^Esa, Gg^Edt, Aa, Aa, Aa^Esa, Aa, Aa^Esa, Aa, Aa^Esa, Aa^Esa, Gs^Esa, Gs, Gg, Gll, Gg^Fdw, Gg, Gs, Gg, Gs, Gg, Ww^Ewl, Gll, Gll, Gd, Gll, Ww, Gd^Fdw, Re, Gd, Gll^Esa, Gg, Gs, Aa^Fda, Aa^Fda, Hh^Vhh, Re, Md, Ms, Ms, Gd, Hhd^Em, Gd, Gd^Fdw, Ha^Fdw, Ms, Ms, Ms^Xm, Ms, Aa
Gs, Gd, Hh, Hh, Mm, Hh^Fdw, Hh^Fdw, Gd, Gs, Re, Rb, Gs, Gll, Gs, Gs, Gs, Gs, Gs, Gs^Edt, Gs^Esa, Gs^Esa, Gs, Gg^Edt, Re, Aa, Aa, Re^Esa, Aa^Esa, Gs, Gs, Gs, Gg^Efm, Gg, Gs, Gs, Gs, Gg^Vh, Gg, Gd, Gd, Gs, Gs, Ww, Wo, Ww, Gd, Gll, Gll^Esa, Gg, Gg^Esa, Gd^Fdw, Gd, Re, Re, Md, Md, Ms, Ha, Ha^Fdw, Gd, Ha^Fdw, Ha, Ms, Ha, Ms, Ms, Ms, Ms
Gs, Gd, Hh^Fdw, Hh, Mm, Mm^Xm, Mm, Hh, Hh, Gs, Gs, Rb, Rb, Gll, Gll, Gs, Gs, Aa, Aa, Gs^Esa, Gs, Gs^Edt, Gd, Re, Re, Re, Gg^Efm, Gg^Efm, Gs, Gll, Gs, Gg^Wm, Gg^Efm, Gs^Efm, Gs^Efm, Gg, Gg, Gd, Gll, Gll, Ww, Ww, Gll^Esa, Ww, Gll, Gll, Gs, Gs, Aa^Fda, Gs, Re, Re, Md, Md, Ms, Ms, Ms, Ms^Xm, Ms, Ha^Fdw, Ms, Ms, Ms, Ms, Re, Hh, Ms, Ms
Gs, Hh, Mm^Xm, Hh^Fdw, Mm, Mm, Mm, Mm, Mm, Mm, Hh, Gs, Gs, Rb, Rb, Gll, Gll, Gs, Gd, Gd, Gd^Em, Gd^Em, Gs^Em, Gd, Gd, Gd, Gs, Gg^Efm, Gs, Gs, Gs, Gs, Gs, Gs, Gs, Gs, Gs, Gll, Wwr, Wwr, Gll, Gll^Edt, Gd, Gll^Edt, Gll, Gd, Re, Re, Re, Re, Md, Md, Ha, Ha^Dr, Ha^Fdw, Ms, Ha, Ms, Ms, Ms^Xm, Ms, Ms, Ha^Esa, Ha, Re, Hh, Hhd, Ms
Gs, Mm, Mm, Mm^Xm, Mm, Mm, Mm, Mm, Hh, Hh^Fdw, Gd^Fdw, Gs, Aa, Aa, Aa, Rb, Rb, Gd, Re, Re, Re, Gs^Fdw, Rb, Hhd^Fdw, Hhd^Fdw, Gs, Gs, Gs, Gs^Esa, Gll^Esa, Gll^Esa, Gll^Esa, Gs, Gs^Esa, Gs^Edt, Gll, Gs^Fdw, Gs^Fdw, Wwr, Gll^Edt, Gs, Gd, Gll, Gll, Re^Es, Re^Es, Ds, Ds, Ww, Re, Re, Hh^Vhh, Re^Fdw, Ms, Gs^Fp, Gd^Fdw, Aa^Fda, Ms, Ms, Ms, Ms, Ha, Ha^Esa, Ha^Esa, Ha^Esa, Re, Hh, Hhd
Gs^Fdw, Hh^Fdw, Hh, Mm, Mm, Mm, Hh^Fdw, Mm, Gd^Fdw, Hhd^Fdw, Gs, Gs, Gs, Gs, Gs, Aa, Rb, Rb, Gs, Gd, Gd, Re, Gs, Re, Rb, Gs^Ve, Gs, Gs, Gs, Gll, Gs, Gs, Gg, Gs, Gs, Gll^Edt, Gll^Edt, Gll, Gll, Gll, Gs^Edt, Gs^Edt, Re^Es, Re, Gs^Edt, Chr, Chr, Chr, Chr, Chr, Wwf, Re, Re, Re^Fdw, Re, Gs, Re, Gs, Gs, Ms, Ms, Ms, Ms, Ms, Ms, Re, Re, Hh
Mm, Mm, Mm, Mm^Xm, Gd, Gd, Gd^Fdw, Gll, Gs, Gs, Re, Aa, Re, Re, Re, Re, Gs, Gs^Efm, Gg^Esa, Gs, Gs, Gll, Gll, Hhd^Fdw, Gd, Rb, Re, Re, Gd, Gs, Gd, Gg, Gg, Gg, Gs, Gll, Gs, Gs, Gll, Gs, Gs, Gs, Re^Es, Gs^Edt, Ww, Chr, Chr, 2 Khr, Ww, Chr, Wwf, Ww, Ww^Ewf, Ww^Ewl, Wwf, Re, Wwf, Re, Re, Gs, Gd, Ms, Gd^Fdw, Hhd^Em, Hhd^Fdw, Ms, Ha, Re
Mm, Mm, Mm, Mm^Xm, Mm, Gs, Re^Es, Gs, Re, Re, Gs^Ve, Re, Gs, Gs, Gd, Gd, Gg^Efm, Gg^Esa, Gll^Fdw, Gs^Fdw, Hhd^Fdw, Gs, Gg, Gll^Fdw, Gll, Gd^Edt, Gs^Edt, Re, Re, Gd, Re, Gd, Re, Gs, Gs, Gs, Re^Es, Gd, Gs, Gd, Re, Re, Gs, Gs, Chr, Chr, Chr, Chr, Hh^Em, Wo, Wwr, Aa^Fda, Gd, Gll, Gd, Wwf, Gd, Wwf, Gs, Re, Re^Es, Gd^Fdw, Gs, Hh^Fdw, Hh, Ms^Xm, Ms^Xm, Ms^Xm
Mm, Mm, Mm, Mm, Re, Re^Es, Gs, Re, Gll, Gll, Gll, Gs, Gs, Gd, Gs, Gs, Gg^Esa, Gll^Esa, Gs^Fdw, Hhd^Fdw, Gg^Fdw, Gg, Gg^Efm, Gg, Gg, Gll, Gll^Edt, Gs, Gs, Gs, Gs, Re, Gd^Vh, Re, Re, Re^Es, Gd, Re, Re, Re, Gs, Gs^Ve, Gs, Chr, Gs, Hh, Hh, Hh^Em, Gs, Ww, Aa^Fda, Aa^Fda, Gs^Edt, Gs^Wm, Gs, Gd, Gs^Fdw, Gs, Gs, Gd, Gd, Re^Es, Re^Es, Hh, Rb, Hh, Hhd, Ms
Re, Mm, Re, Re, Gs^Fdw, Gs^Fdw, Gg, Gll, Gs, Gs, Gs, Gs, Gs, Gs, Gll, Gs, Gs, Gll, Gs, Gll, Gll, Gll^Fdw, Gg, Gg^Efm, Gg, Gg, Gll^Edt, Gll^Dr, Gll, Gll, Re, Re, Gd, Gs, Gll, Gs, Gg, Gs, Gs, Gs, Gg, Gll, Gs, Gll, Gll^Edt, Gs^Edt, Gll, Gll, Gs^Edt, Gs^Edt, Gs^Edt, Gs^Edt, Gs, Gs, Gs, Gs^Fdw, Gs^Fdw, Gg, Gd^Ve, Gs, Gs, Gs, Gs^Fdw, Re, Re^Es, Rb, Mm, Hhd
Gs^Fdw, Re, Gll^Fdw, Gll^Fdw, Gg, Gg, Gs, Gg, Gg, Gg^Efm, Gg^Efm, Gs, Aa^Esa, Gs, Gg^Efm, Gs, Gg^Efm, Gs, Gd, Gs, Gs, Gs, Gs, Gs, Gs, Gg, Gg, Gg, Gs^Efm, Re, Gs, Gs, Gg^Efm, Gg^Efm, Gs, Gs, Gs^Efm, Gg^Fdw, Gg, Gg, Gd, Gll, Gll, Gll^Edt, Gg, Gll, Gg, Gg, Gs, Gs, Gll, Gll, Gll, Gll, Gll, Gs, Gs, Gs, Gg, Gg, Gs^Efm, Gs, Gll, Gs^Fdw, Gll^Fdw, Rb, Rb, Hhd
Gg^Fdw, Gs, Gg, Gg, Gg, Gs, Ds, Gs, Ds, Ds, Gg^Efm, Aa, Aa^Esa, Gs, Gs^Esa, Gg^Esa, Ds, Gs, Gs, Gs, Ds, Gll, Gll^Fp, Gs, Gs, Gg, Gg, Gg, Gs^Efm, Re, Gs, Gg^Efm, Gg^Efm, Gg, Gg, Gg^Edt, Gg^Efm, Gs^Efm, Gs^Efm, Gg, Gg, Gg, Gg, Gg^Edt, Gg, Gg, Hh^Em, Hh^Em, Hh, Ww, Ww, Ww^Bw/, Gll, Ww, Wwr, Gll, Gll, Gs, Gll, Gg, Gs^Efm, Gg^Efm, Gll, Gs^Fp, Gs, Gd^Fp, Gs, Rb
Gg, Gg, Gg, Gg, Gs, Gg^Efm, Gg^Efm, Ds, Gg, Ds, Gs, Aa, Aa, Aa^Esa, Gs^Fp, Gs^Fdw, Gs^Fdw, Gs, Aa, Gs, Gs, Gs, Gg^Fet, Gll^Fp, Gs, Gs, Gs, Gg, Gs^Efm, Re, Re, Gll, Gll, Gg, Gll^Fdw, Gg, Gg, Gll, Gd, Gg, Gs, Gs, Gd, Gs, Gs, Gs, Hh, Ds, Ds, Ww, Ds, Ww, Ww^Ewf, Wo, Wwr, Gll^Fp, Gll, Gs, Gs, Gg, Gg, Gg, Gll^Dr, Gs^Fdw, Gll, Gd, Gd, Gs
Gg, Gs^Efm, Gg, Gg, Gs, Gll, Gs, Ds, Gg, Gg, Gll^Fp, Gs, Gs, Aa, Aa, Gs^Fp, Aa, Aa, Aa^Fdw, Gs, Gs, Gd, Gd, Gd^Fetd, Gll^Fp, Gs, Gd, Gg, Gll^Fp, Gs^Efm, Gs^Efm, Rb, Gll, Gg, Gg, Gg, Gg, Gs^Efm, Gg, Gg, Gg, Gs, Gg, Gd, Gd, Hh, Gd, Gd, Gs, Ds, Gs, Ds, Ww^Ewl, Ww, Ww, Gs^Fp, Gll, Gg, Gg, Gg, Gs, Gg, Gg, Gll^Fdw, Gll, Gd, Gll, Gd
Gg, Gg, Gs^Efm, Gd, Gd^Esa, Aa^Esa, Gd^Esa, Ds, Gs, Gll^Fp, Gll^Fp, Gg, Gs, Aa, Gd, Aa, Gs, Aa, Gg, Aa, Gs, Ds, Gs, Gd, Gd, Gd, Gs, Gg, Gll^Fp, Gg, Gs^Efm, Rb, Gd, Gg, Gg^Esa, Gg^Efm, Gg, Gg, Gs^Fdw, Gg, Gd, Gg, Gd, Gll, Gll^Fdw, Gd, Gs, Hh^Fp, Hh, Gs, Gs, Gd^Em, Gd^Emf, Gs^Fp, Gll^Fp, Gs^Fp, Gll, Gg, Gd^Fdw, Gs, Gg^Efm, Gd, Gd, Gd^Efm, Gg, Gll^Dr, Gs, Gs
Gs^Efm, Gs^Efm, Gs, Gs, Aa^Esa, Aa^Esa, Aa, Gd, Gd^Em, Gd, Gd^Fdw, Gg, Aa, Gs, Aa, Aa, Aa, Gd, Aa^Esa, Gg, Aa^Esa, Gs^Esa, Aa^Esa, Aa, Gg, Gs, Gs, Gg, Gg, Gll^Fp, Gg, Rb, Gs^Esa, Gs^Esa, Gll, Gll, Gll, Gg, Gs, Gg, Gg, Gd, Gs, Gll, Gg, Gg, Gs^Edt, Hh, Gs, Gs, Gll, Gd^Em, Gs, Gs^Fp, Gs, Gll, Gs, Gg, Gs, Gs^Fdw, Gg, Gg, Gg^Ve, Gd, Gd^Efm, Gg^Efm, Gs, Gll
Gs, Gs^Efm, Gs^Fp, Gd^Fdw, Aa, Aa, Aa, Aa, Ai, Aa, Aa^Fdw, Gs^Fp, Aa^Fdw, Gg, Gg^Efm, Gd, Aa, Gs, Gg^Efm, Aa^Esa, Aa^Esa, Aa^Esa, Ai, Aa, Aa, Gg, Gs, Gs, Gs, Gll, Gs, Rb, Aa^Esa, Gll, Aa^Es, Hh, Hh, Gll, Gll, Gs, Gg^Edb, Gd, Gs, Gg, Gg, Gd, Gs^Edt, Gll, Gll, Gg^Vh, Gll, Gs, Gg, Gs, Gd, Gs, Gg, Gg, Gg, Gs, Gg, Gg, Gs^Efm, Gg, Gd^Efm, Gs, Aa^Esa, Gs
Gs, Gs, Gd^Fdw, Aa, Gs, Aa, Aa^Fdw, Aa, Aa, Aa, Aa, Aa, Aa, Aa^Fdw, Aa^Es, Gd^Em, Gd^Em, Aa, Aa, Aa^Esa, Aa, Aa, Ai, Ai, Aa, Aa, Gs^Efm, Gs^Fdw, Aa, Gs, Gg, Rb, Aa^Esa, Aa^Es, Aa, Aa, Aa^Esa, Hh, Gll, Gs^Edb, Gg^Edb, Gs, Gd^Edt, Gs, Gs, Gg, Gs^Edt, Gll, Gs, Gll, Gs, Gg^Efm, Gg, Gg, Gs^Fp, Gd, Gs^Ve, Gs, Aa^Fpa, Gg, Gg, Gg^Efm, Gg^Efm, Gd^Efm, Gg^Efm, Gs, Aa^Esa, Aa
Gs, Gs, Gd, Aa, Gd, Gs, Gs^Fdw, Aa, Gd^Em, Aa, Aa, Aa, Aa, Aa, Aa, Aa^Es, Aa, Aa, Aa, Aa, Aa, Aa, Aa, Aa, Gg^Efm, Aa, Aa^Fdw, Gs, Aa, Aa, Aa, Aa, Ai, Ai^Es, Aa, Ai^Esa, Aa^Esa, Hh^Em, Ds, Gg^Edb, Gs, Gs, Gd^Edt, Gd^Wm, Gs, Gs, Gs, Gg^Efm, Gg^Efm, Gs, Gs^Fdw, Gg^Fdw, Gd^Fdw, Gs^Fdw, Gs^Fdw, Aa^Fpa, Aa^Fpa, Aa^Fpa, Gs^Fp, Gg, Gd, Gs^Fp, Gs, Gs, Gd, Gd^Esa, Aa, Aa
Gs^Fdw, Gs^Fdw, Ds, Gd, Gg, Gs, Gs, Aa, Gd, Aa, Aa, Aa, Aa, Aa, Aa, Aa^Esa, Aa, Aa, Aa, Aa, Aa, Aa, Aa, Gg, Gg^Efm, Aa, Gg, Gs, Gg, Aa, Aa, Ai, Aa, Ai, Aa, Aa, Hh^Em, Hh^Em, Gg, Gg^Edb, Gg, Gd, Gll, Gll^Edt, Gs^Edt, Gs, Gg, Gg, Gg, Gg^Efm, Hh^Fp, Gs^Fp, Hhd^Dr, Gd, Hh, Mm, Aa^Fpa, Aa^Fpa, Aa^Fpa, Gd, Hh, Gd, Hh, Hh, Aa, Aa^Fdw, Aa^Fdw, Aa
Ds, Gs, Ds, Gg, Gs^Efm, Gll^Fp, Gll^Fp, Gs^Esa, Aa^Esa, Aa, Aa, Ai, Ai, Aa, Aa, Aa, Aa, Ai, Aa, Aa, Ai, Aa, Gd, Aa, Aa, Gg, Aa, Gs, Gg^Efm, Gg, Gs, Aa, Gs^Esa, Aa^Esa, Aa^Esa, Hh, Gs^Edb, Gs^Edb, Gg, Gd^Edb, Gd, Gs, Gd, Gs, Gs, Gs^Edt, Hh, Hhd^Em, Hh^Fp, Hh^Fp, Hh, Hh, Hh, Hhd, Aa^Fpa, Aa^Fpa, Aa^Fpa, Aa^Fpa, Aa^Fpa, Hh, Hhd, Hhd, Hhd^Fp, Hh^Fp, Hh^Fp, Aa^Fdw, Aa, Aa
Ds, Ds, Ds, Ds, Gs^Efm, Gll^Fp, Gg, Gd^Esa, Aa^Es, Ai, Aa, Aa, Aa, Ai, Ai, Aa, Aa, Ai, Aa, Ai, Aa, Aa, Gd^Em, Gs, Gd^Edb, Aa, Aa, Gg^Efm, Aa, Gg^Efm, Gll^Fp, Gs, Gll^Fp, Gs^Fdw, Gs, Aa^Esa, Gg, Gg, Gg^Efm, Gd, Ww, Gd^Em, Ww, Gd, Gs^Fdw, Gs^Fdw, Gd^Fdw, Gs^Fp, Gs^Fp, Md, Hh^Fp, Md, Gg, Aa^Fpa, Aa^Fpa, Aa^Fpa, Aa^Fpa, Aa^Fpa, Aa^Fdw, Aa^Fdw, Gd, Gll, Gd, Gll, Gd, Gs^Fdw, Aa, Aa
Gg, Gg, Gg, Gs^Efm, Gg, Gg, Gg, Gd, Aa^Es, Ai, Ai, Ai, Aa, Aa, Aa, Aa, Aa^Fdw, Aa, Aa^Fp, Aa, Aa^Esa, Aa^Esa, Aa, Gs^Fdw, Gs^Edb, Aa, Aa^Esa, Aa, Aa, Gg, Gll^Fp, Gll^Fp, Gs, Gs^Fdw, Gs, Gd, Gll, Gg, Gg, Gll, Gll, Ww^Ewl, Gll, Gs, Aa^Fpa, Aa^Fpa, Aa^Fpa, Gs^Fp, Gs, Gs^Fp, Gd^Fdw, Md, Gs, Aa^Fpa, Aa^Fpa, Aa^Fpa, Hhd, Aa^Fdw, Aa^Fdw, Gd, Gs^Fp, Aa^Fpa, Gs, Gs^Esa, Aa^Esa, Aa, Aa^Esa, Aa
Ds, Ds, Gs^Efm, Gg, Gd, Gg, Gg^Efm, Gd, Gd, Aa^Es, Aa, Ai, Aa, Ai, Ai, Aa, Aa^Fdw, Aa, Gs^Fp, Aa, Gs, Aa, Aa, Aa, Gs, Gd^Edb, Gd^Esa, Aa^Esa, Gd^Em, Gd, Gs, Gs, Gs, Gs, Gll^Fp, Gs, Gs, Gd, Gg, Gg, Gs, Gll, Chr, Gd, Gs, Aa^Fpa, Aa^Fpa, Gs^Fdw, Aa^Fpa, Gd, Aa^Fpa, Gd, Mm^Xm, Mm, Hh, Hh, Hhd^Fp, Aa^Fpa, Aa^Fpa, Aa^Fpa, Aa^Fpa, Aa^Fpa, Aa^Fpa, Aa, Aa, Aa^Esa, Aa, Aa
Gg^Efm, Ds, Gg, Gg, Gs, Gd, Gs, Gs^Efm, Aa, Aa, Gs^Efm, Aa, Gd, Gd, Gd, Aa, Aa, Aa^Fdw, Aa, Gll^Fp, Ds, Gs, Gd, Aa, Gd, Gs^Edb, Gs, Gd, Gg^Efm, Gg^Efm, Gg^Efm, Gll, Gs, Gll^Fdw, Gg^Efm, Gll, Gg^Efm, Gs, Gd^Fdw, Gs, Gs, Chr, Khr, Chr, Chr, Gd, Gg^Vh, Aa^Fpa, Aa^Fpa, Gs^Fp, Gs^Fp, Hh^Fp, Mm, Mm, Hhd, Hhd^Fp, Hhd, Md, Gd, Gd, Aa^Fpa, Aa^Fpa, Gs, Aa^Fpa, Gs, Gd, Aa, Gd
Gg, Gg^Efm, Gg, Gs, Gs^Efm, Gs^Fdw, Aa, Aa, Gs^Fdw, Gs^Efm, Ds, Gs, Aa^Fpa, Aa^Feta, Aa^Fpa, Aa^Fpa, Gs, Aa, Aa, Gs, Gg^Efm, Ds, Gg^Efm, Gd, Gll^Edb, Gs, Gll, Gll, Gll, Gll, Gll, Gll, Gll, Gll^Fdw, Gg^Efm, Gg^Efm, Gll, Gll, Gd^Fdw, Gs^Fdw, Chr, Chr, Chr, Chr, Gd^Fdw, Gd^Fdw, Aa^Fpa, Aa^Fpa, Aa^Fpa, Gs^Fp, Gs^Fp, Hhd, Mm, Mm, Mm^Xm, Gs^Fp, Gs^Fp, Md, Gs^Fp, Gs^Fp, Aa^Fpa, Aa^Fpa, Aa^Fpa, Gs, Aa^Fpa, Gd^Fdw, Gd^Fdw, Gs^Fdw
Gd, Gd, Gd, Gs^Fdw, Aa^Fdw, Aa, Aa, Gg, Gg, Gg, Ds, Ds, Aa^Fpa, Aa^Fpa, Aa^Fpa, Aa^Fpa, Gs, Aa, Aa, Gs, Gll, Gs, Ds, Gll^Edb, Gll, Gll^Edb, Gs^Edb, Gs^Edb, Gs, Gs, Gd, Gd, Gs, Gll, Gll, Gll, Gll, Gll, Gd, Gs, Gs, Gd, Gs, Gs, Aa^Fpa, Aa^Fpa, Aa^Fpa, Aa^Fpa, Aa^Fpa, Aa^Fpa, Gs^Fp, Mm, Mm, Mm, Gg, Gg, Gs^Fp, Gs^Fp, Gs^Fp, Aa^Fpa, Aa^Fpa, Aa^Fpa, Aa^Fpa, Aa^Fpa, Aa^Fpa, Aa^Fdw, Aa^Fpa, Aa^Fpa
