Mm, Mm, Mm, Mm, Mm, Mm, Mm, Mm, Mm, Mm, Mm, Mm, Mm, Mm, Mm, Mm, Mm, Mm, Mm, Mm, Mm, Mm, Mm, Mm, Mm, Mm, Mm, Mm, Mm, Mm, Mm, Mm, Mm, Mm, Mm, Mm, Mm, Mm, Mm, Mm, Re, Mm, Mm, Mm, Mm, Mm, Mm, Mm, Mm, Mm, Mm, Mm, Mm, Mm, Mm, Mm, Mm, Mm, Mm, Mm, Mm, Mm, Mm, Mm, Mm, Mm
Mm^Xm, Mm, Mm, Mm, Mm, Mm, Mm, Mm, Mm, Mm, Mm, Mm, Mm, Mm, Mm, Mm, Mm, Mm, Mm, Mm, Mm, Mm, Mm, Mm, Mm, Mm, Mm, Mm, Mm, Mm, Mm, Mm, Mm, Mm^Xm, Mm, Mm, Mm, Mm, Mm, Mm, Re, Mm, Mm, Mm, Mm, Mm, Mm, Mm, Mm, Mm, Mm, Mm, Mm, Mm, Mm, Mm, Mm, Mm, Mm, Mm, Mm, Mm, Mm, Mm, Mm, Mm
Mm, Mm, Mm, Mm, Mm, Mm, Mm, Mm, Mm, Mm, Mm, Mm, Mm, Mm, Mm, Mm, Mm, Mm, Mm, Mm, Mm, Mm, Mm^Xm, Mm, Mm, Mm, Mm, Mm, Mm, Mm, Mm, Mm, Mm, Mm, Mm, Mm, Mm, Mm, Hhd, Mm, Re, Mm, Mm, Mm, Mm, Mm, Mm, Mm, Mm, Mm, Mm, Mm, Mm, Mm, Mm, Mm, Mm, Mm, Mm, Mm, Mm, Mm, Mm, Mm, Mm, Mm
Mm, Mm, Mm, Mm, Hhd, Mm, Mm, Hh, Hh, Mm, Hh, Mm, Hhd, Mm, Mm, Mm, Mm, Mm, Mm, Mm, Mm, Mm, Mm, Mm^Xm, Mm, Mm, Mm, Mm, Mm, Mm, Mm, Mm, Hhd, Mm, Mm, Mm, Hhd, Hhd, Mm, Mm, Re, Mm, Hh, Mm, Mm^Xm, Mm, Mm, Mm, Mm, Mm, Mm, Mm, Mm, Mm, Mm, Mm, Mm, Mm, Mm, Mm, Mm, Mm, Mm, Mm, Mm^Xm, Mm
Hh, Hhd, Hhd, Hhd, Hhd, Mm, Hhd, Hhd, Hhd, Hh, Hh, Hh, Hhd, Mm, Mm, Mm, Mm, Mm, Mm, Mm, Mm, Mm, Mm, Mm, Mm, Mm, Hhd, Hhd, Hhd, Hhd, Hhd, Mm^Xm, Hhd, Mm, Re, Mm, Mm, Mm, Mm, Mm, Re, Mm, Mm, Hh, Mm, Mm, Mm, Mm, Mm, Mm, Mm, Mm, Mm, Mm, Mm, Mm, Mm, Mm, Mm, Mm, Mm, Mm, Mm, Mm, Mm, Mm
Hh, Hhd, Hh, Hh, Hhd, Mm, Mm, Hh, Hh, Hh, Hh, Hh, Hh, Hhd, Hh, Mm, Hh, Mm, Hhd, Mm, Hhd, Mm, Mm, Mm, Mm, Mm, Mm, Mm, Mm, Mm, Mm, Hhd, Hhd, Rb, Mm, Mm, Mm, Mm, Mm, Mm, Mm, Re, Rb, Hh, Hh, Mm, Mm, Mm, Mm, Mm, Mm, Mm, Mm, Mm, Mm, Mm, Mm, Mm, Mm, Mm, Hh, Mm, Mm, Mm, Mm, Mm
Hh, Hh, Hh, Hh, Hhd, Mm, Mm^Xm, Hh, Hh, Hh, Hhd, Hh, Hhd, Hh, Hh, Hh, Hh, Hhd, Hhd, Hhd, Hh, Hh, Hh, Hh, Mm, Mm, Mm, Mm, Mm, Mm, Mm, Hhd, Mm, Mm, Mm, Mm, Mm, Mm, Mm, Mm, Mm, Hh^Vhh, Hh, Rb, Rb, Hh, Hh, Mm, Mm, Mm, Mm^Xm, Mm, Mm, Mm, Mm, Mm, Mm, Mm, Hh, Hh, Mm, Mm, Mm, Mm, Mm, Mm
Hhd, Hh, Hh, Hh, Hh^Dr, Mm, Mm, Mm, Mm, Hhd, Hhd, Hh, Hh, Hh, Hh, Mm, Mm, Hhd, Hh, Mm, Mm, Mm, Mm, Hh, Mm, Rb, Hhd, Hhd^Dr, Hhd, Hhd, Hh, Re, Hh, Hh, Hh, Hh, Hh, Mm, Mm, Hh, Mm, Mm, Mm, Hh, Hh, Re, Mm, Hh, Hh, Mm, Mm, Mm, Mm, Mm, Mm, Mm, Hh, Hh, Hh, Mm, Mm, Mm, Mm, Mm, Mm, Mm
Hhd^Dr, Hhd, Hh, Hh, Mm, Mm, Hh, Mm, Hhd, Hhd, Hhd^Dr, Hhd, Hhd, Hhd, Hh^Edt, Mm, Hh, Hhd, Hh, Hh, Mm, Mm, Hh, Mm, Rb, Rb, Hh, Hhd, Hh, Hhd, Hh, Re, Rb, Hhd, Hhd, Hhd, Hhd, Hhd, Hh, Hh, Mm, Mm, Mm, Mm, Mm, Hhd, Ds, Re, Hh, Mm, Mm, Mm, Hh, Mm, Hh, Hh, Hh, Hh, Mm, Mm, Mm, Mm, Mm, Mm, Mm, Mm
Gs, Hhd, Hh, Hh, Hh, Hh, Hh, Hh, Hh, Hh, Hhd, Hhd, Hh, Hh, Hh^Edt, Hh^Edt, Hh, Hh, Hhd, Hh, Hh, Hh, Re, Re, Hh, Hh, Hh, Hh, Hhd, Hhd, Hh, Re, Hh, Hh, Hh, Hh, Hh, Hh, Hh, Hh, Hh, Hhd^Vhhr, Hhd, Mm, Hhd, Hhd, Re, Re, Hh, Hh, Hh, Mm, Mm, Hh, Hhd, Mm, Mm, Hh, Mm, Mm, Mm, Mm, Mm, Mm, Mm, Mm
Gd^Edt, Gs, Gg, Hh, Hh, Hh, Hh, Mm, Mm, Mm, Mm, Hh, Chr, Hh, Hhd^Vhhr, Hh, Gs, Hh, Gs, Hh, Gg, Re, Hh, Hh, Hh, Hhd, Hhd^Vhhr, Hhd, Hh, Hh, Mm, Re, Re, Hh, Hh, Hh, Hh, Hhd, Hh, Hh, Hhd, Hhd, Hh, Hhd, Gs, Gs, Re, Gs, Hh, Hh, Hh, Mm^Xm, Mm, Mm, Mm, Hhd, Hhd, Mm, Mm, Mm, Mm, Mm, Mm, Mm, Mm, Mm
Gg, Gg, Gs, Gg, Gg, Hh, Mm, Mm, Mm, Gg, Gs, Rp, Chr, Chr, Chr, Gg, Gs^Edt, Gg^Edt, Gg, Gg, Gg, Gg, Gs, Gs, Gs, Hhd, Hhd, Hh, Gd, Mm, Gd, Mm, Gs, Gs, Gs, Gs, Gs^Efm, Gs^Efm, Gs^Efm, Gs^Efm, Gs^Efm, Gs^Efm, Gs^Efm, Gs, Gg^Efm, Gs^Edt, Gd^Edt, Re, Gs, Hh, Hh, Hh, Hh, Mm, Mm, Mm, Hhd, Mm, Mm, Mm, Mm, Mm, Mm, Mm, Mm, Mm
Gs, Gs, Gs, Gg^Em, Gs, Gg, Gg, Gg, Gs, Gs, Gs, Rp, Chr, 1 Khr, Chr, Chr^Edt, Chr, Gg^Edt, Gg^Edt, Gg, Gg, Gg, Gg, Gs^Edt, Gs^Edt, Gd, Gs, Gd, Gs, Gd, Gs, Gs, Gs, Gs, Gg, Gs, Gs, Gg^Efm, Gg, Gg, Gg, Gs^Efm, Gg, Gg, Gg, Gs, Gll, Re, Gs, Gs, Gg, Hh, Hh, Hh, Hh, Mm, Mm, Hhd, Mm, Mm^Xm, Mm, Mm, Mm, Mm, Mm, Mm
Gs, Gs, Gs, Gs^Edp, Gs^Es, Gs, Gg, Gs, Gs^Edt, Gs, Gs^Edt, Gs^Edt, Gs^Edt, Chr^Edt, Gd^Ve, Chr, Rp, Gs, Gg, Gd, Gg, Gg, Gg, Gs, Gs^Edt, Gs, Gs, Gll, Gll, Gll, Gs^Edt, Gs^Edt, Gs, Gs, Gs, Gs, Gg^Efm, Gg^Efm, Gg, Gg, Gg, Gs^Ve, Gg^Efm, Gg, Gg, Gd, Gs, Gd, Re, Gs, Gg, Gg, Gs, Hh, Hhd, Hhd, Hhd^Vhhr, Hhd, Mm, Mm, Mm, Mm, Mm, Mm, Mm, Mm
Gg, Gs, Gd^Edt, Gs, Gs, Gg^Es, Gs, Gs, Gd, Gs, Gs, Gs, Gs, Chr, Gd, Gs, Gd^Edt, Gg, Gg^Edt, Gg, Gg^Edt, Gg, Gs, Gg, Gs^Edt, Gs, Gd^Ecf, Gll, Gd, Gs^Edt, Gg^Efm, Gs^Edt, Gg, Gs, Gg^Efm, Gg^Efm, Gg, Gg, Gg, Gg, Gg, Gg, Gg, Gg, Gd, Gd, Gd, Gd^Edt, Re, Gs^Edp, Gs, Gg, Gg, Gd, Hh, Hh, Hh, Hhd, Hh, Hh, Gd, Gd, Gd, Mm, Mm, Mm
Gs, Gs, Gd^Edt, Gs, Gs, Gg, Gs, Gd, Gd, Gd^Edt, Gs, Gs, Gs, Gs, Gs, Gd^Edt, Gg^Edt, Gd^Edt, Gd^Edt, Gg^Edt, Gs, Gs, Gs, Gs, Gs, Gs^Edt, Gd, Gd, Gs^Edt, Gs^Edt, Gs^Edt, Gg, Gs, Gs, Gg^Efm, Gg^Efm, Gg, Gg, Gg, Gs, Gs, Gs^Es, Gs^Es, Gd^Es, Gd, Gg, Gg, Gd, Gd, Re, Gs, Gg, Gg, Gs, Gs, Gs, Re, Hh, Hh, Hh, Gs, Gd, Gg, Gd, Gd, Hh
Gs, Gs, Gs, Gg, Gg, Gg, Gs, Gs^Vl, Gd, Gd, Gd, Gs, Gg, Gs, Gs, Gs, Gs, Gs, Gd^Edt, Gg, Gs, Gs^Edp, Gd, Gs, Gs, Gs, Gd, Gg, Gs, Gs^Edt, Gs^Edt, Gg, Gs, Gg, Gg, Gg, Gg, Gg, Gs^Vl, Gg, Gs, Gg^Es, Gg, Gg, Gg, Gg, Gg^Efm, Gg, Gs, Re, Re, Gs, Gg, Gg, Gg, Gg, Re, Hh, Hh, Hhd, Gg, Gg, Ss, Gg, Ss, Hh
Gs^Edt, Gs, Gs, Gg^Efm, Gg^Efm, Gg^Efm, Gd, Gs, Gs, Gs, Gs, Gg, Gg, Gs, Gs, Gs, Gg^Edt, Gg^Edt, Gg, Gg, Gs, Gs, Gd, Gd, Gd, Gs, Gd, Gg, Gs, Gs^Edt, Gg^Efm, Gs^Edt, Gs, Gg, Gg, Gg, Gs, Gs, Gs, Gs, Gg, Gs, Gs, Gg, Gg, Gg, Gg, Gg, Gg, Gg, Re, Gs, Gs, Gg, Re, Re, Gs, Gs, Hh, Hh, Hh, Ss, Ss, Ss, Ss, Ss
Gs^Edt, Gs^Edt, Gs, Gs, Gd, Gs, Gs, Gs, Gs, Gs, Gg, Gg, Gg, Gg, Gg, Gs, Gg^Edt, Gg^Edt, Gd, Gg, Gs, Gs, Gs, Gs, Gs^Vl, Gg, Gg, Gg, Gs, Gs, Gs, Gs^Edt, Gs^Edt, Gg, Gg, Gg, Gg, Gs, Gg, Gg, Gs, Gs, Gs, Gg, Gg^Edt, Gg, Gg, Gg, Gg, Gg, Gg, Re, Re, Re, Gd, Gd, Gg^Efm, Gs, Ds, Hh, Ss, Ss, Ss, Sm, Ss, Ss
Gs, Gs, Gs, Gd, Gd, Gs, Gd, Gs, Gs, Gg, Gg, Gs, Gs^Ve, Gg, Gs, Gg, Gg, Gg^Es, Gd^Es, Gd^Es, Gd^Edt, Gd, Gs, Gs, Gs, Gs, Gs, Gs, Gs, Gs, Gs, Gs^Edt, Gs, Gg, Gs, Gs, Gg, Gg, Gg, Gg, Gs, Gd, Gd, Gs, Gs^Edt, Gg, Gs^Edt, Gg, Gg, Gs, Gs, Gg^Ve, Re, Gd, Ds, Gg^Efm, Ds, Ds, Ss, Ss, Ww, Ss, Ss, Sm, Ss, Ss
Gs, Gg, Gs, Gd, Gs, Gd, Gd, Gs, Gs, Gg, Gs, Gs, Gs, Gs, Gs, Gg, Gs, Gs, Gd, Gd, Gs, Gs^Edt, Gs, Gs^Edt, Gs, Gs, Gs, Gs, Gs^Edp, Gd, Gs, Gs, Gs, Gs, Gs^Vl, Gs, Gg, Gg, Gg, Gs, Gg, Gd^Es, Gs, Gs^Edt, Gs, Gs^Edt, Gs, Gs^Edt, Gg, Gs, Re, Re, Ss, Gd, Ds, Ss, Ds, Ds, Ss, Ww, Ss, Ww, Ss, Sm, Sm, Ss
Gs, Gg, Gg, Gd, Gs, Gs, Gs, Gd, Gs, Gs, Gs^Edt, Gs, Gs, Gs, Gs, Gs, Gs, Gs, Gs, Gs, Gg, Gs, Gs, Gs, Gg, Gs, Gs, Gll, Gs, Gd, Gd, Gd, Gd, Gd, Gs, Gs, Gd, Gd, Gs, Gg, Gd, Gd, Gs, Gs, Gg, Gg, Gg, Gs, Re, Re, Ss, Ss, Ss, Gd, Ss, Ss, Ss, Ss, Sm, Ss, Ss, Ss, Ss, Ww, Sm, Ss
Gg, Gg, Gs, Gs, Gs^Edt, Gs^Edt, Gs^Edt, Gs^Edt, Gs^Edt, Gs^Edt, Gd, Gs, Gs, Gs, Gg^Edt, Gs, Gd, Gd, Gg, Gg, Gg, Gs, Gs, Gg, Gg, Gd, Gs, Gs, Gs^Edt, Gd, Gs^Edt, Gs^Edt, Gs^Edt, Gs, Gg, Gd, Gg^Efm, Gs, Gs, Gs, Gd, Gs, Gs, Gg, Re, Re, Re, Re, Ss, Ss, Gg, Ss, Gd, Ss, Ds, Ss, Ss, Ss, Rb, Sm, Sm, Sm, Ss, Ww, Ww, Sm
Gs, Gs, Gs, Gs, Gs^Edt, Gg, Gg, Gg, Gg^Es, Gg, Gs, Gs, Gg, Gs, Gd^Edt, Gd, Re, Re, Re, Re, Re, Gg, Gg, Gg, Gg, Gs, Gs, Gs, Gs^Edt, Gs^Edt, Gs, Gs, Gs, Gs, Gg, Gd, Gg^Efm, Gs, Gg^Efm, Gd, Gd, Gs, Re, Re, Gll, Gll, Gll, Re, Re, Gs^Vh, Re, Gg, Gd, Ss, Ss, Ss, Ss, Rb, Gs^Edt, Rb^Fetd, Rb, Sm, Ds, Ss, Ww, Ww
Gg, Gd, Gs, Gs, Gs, Gs, Gg, Gg, Gg, Gg, Gg, Gg, Gd, Gd, Re, Re, Gs, Gs, Gs^Es, Gs, Gs, Re, Re, Gs^Ve, Gg, Gs, Gs, Gg, Gg, Gs, Gg, Gd, Gg, Gg, Gg, Gg^Efm, Gg^Efm, Gg^Efm, Gs, Gd, Re, Re, Sm, Ss, Gs, Gs, Gg, Gs, Gs, Re, Gs, Re, Re, Re, Ss, Ss, Ss, Ss, Gs^Edt, Gs, Rb, Sm, Sm, Ss, Ss, Ww
Gs, Gg, Gs, Gs, Gd, Gs, Gd, Gs, Re, Gg, Re, Re, Re, Re, Gs^Es, Gs, Gs, Gg^Edp, Gs^Es, Gs, Gs, Gs, Gd, Re, Re, Gg, Gd, Gs, Gg, Rp, Rp, Gg, Gg^Efm, Gg, Gg, Gg, Gd, Gd, Gs, Gd, Re, Ss, Gd, Ss, Gs, Gs, Gs, Gg, Gg, Gg, Gg, Gd, Gd, Re, Re, Gg, Gs^Edt, Ss, Ss, Gs^Edt, Gs^Edt, Rb, Rb, Ss, Ss, Ss
Gs, Gs, Gd, Gd, Re, Gd, Re, Re, Ww, Re, Sm, Gs, Gs, Gs, Gd, Gs, Gg, Gs, Gs^Es, Gs^Es, Gs, Gd, Gs, Gd, Gs, Re, Re, Rp, Chr, Rp, Chr, Rp, Ch, Gg, Gd, Gd, Re, Re, Re, Re, Gg, Gd, Ss, Gs, Ss, Gs, Gs, Gs, Gs, Gs, Gs, Gs, Gs, Gd, Gs, Re, Re, Re, Re, Gs^Edt, Gs, Gs, Ds, Ss, Ss, Ss
Gs^Edt, Gs, Re, Re, Ww, Re, Sm, Sm, Sm, Sm, Gs, Gs, Gd, Gd, Gs, Gd^Edt, Gd, Gg, Gg, Gs, Gg^Ecf, Gs, Gs, Gs, Gs, Gs^Ve, Rp, Rp, Chr, Ch, 2 Khr, Chr, Chr, Re, Rp, Re, Gg, Re, Gs, Gg^Ve, Gg, Gd, Sm, Sm, Ss, Ss, Gs, Gs, Gs, Gd, Gs^Vh, Gs, Gs^Edp, Gs^Edp, Gs, Gd, Gs, Gs, Gs^Es, Re, Re, Gs, Gs, Ds, Ds, Ss
Re, Re, Sm, Ww, Ww, Ww, Ww, Sm, Sm, Sm, Gs, Gg, Gs^Ve, Gs, Gs, Gs, Gs, Gg, Gs, Gs, Gd, Gs, Gs, Gs, Rp, Gs, Gd^Es, Re, Rp, Ch, Rp, Rp, Rp, Rp, Rp, Gg, Rp, Gg, Gg, Gg, Gd, Gd, Gg, Sm, Ss, Gs, Gs, Gs, Gs, Gd, Gd, Gs, Gs, Gs, Gs, Gs, Gs^Vl, Gs, Gs, Gs, Gg, Re, Re, Re, Ds, Ss
Sm, Sm, Sm, Sm, Sm, Sm, Sm, Ww, Ww, Sm, Ss, Gs, Gs, Gg, Gs, Gs, Gs, Gg, Gs, Gs, Gs, Gg, Gg, Gg, Gg, Rp, Rp, Rp, Gg, Ch, Rp, Gd^Es, Gs^Vh, Gs, Gs, Rp, Gs, Gd^Es, Rp, Gd, Gg, Gg, Ss, Ss, Gg, Gs, Gs, Gs, Gs, Gd, Gd, Gd, Gd, Gs, Gg, Gs, Gs, Gs, Ds, Ds, Ds, Gg, Gg, Re, Re, Ds
Sm, Sm, Ww, Sm, Ds, Sm, Ds, Ds, Sm, Ss, Ss, Gs, Gs, Gg, Ds, Gs, Gs, Gs, Ds, Gs, Ds, Gs, Gs, Gg, Gg, Gs, Gs, Re, Gs, Gg^Efm, Rp, Rp, Gd, Gd^Es, Gd, Gs, Gs, Gg^Efm, Gg^Efm, Gg, Gg^Efm, Gg, Gg^Efm, Gg, Gs, Gs, Gs, Ww, Ww, Ww^Bw/, Gd, Gd, Ww, Gs, Gg, Gs, Ch, Ds, Chr, Chr, Rp, Rp, Gg, Gs, Gs, Re
Sm, Sm, Ww, Ww, Ww, Ds, Sm, Ds, Sm, Ss, Ss, Ss, Gd, Gs, Gs, Gs, Ss, Gs, Gs, Gs, Ds, Ds, Gs, Gg, Gg, Gs, Gg, Re, Re, Gs, Gs, Rp, Gs, Gs, Gs, Gll, Gs, Gg^Efm, Gg, Gg^Efm, Gg, Gg^Efm, Gd, Gg^Efm, Gs, Gg, Gs, Ww, Gd, Ww, Ww, Wo, Ww, Gg, Rp, Ch, Kh, Chr, Ch, Rp, Gd, Gd, Gd, Gg^Efm, Gs, Gs
Sm, Sm, Sm, Ww, Ww, Ds, Sm, Sm, Ds, Sm, Sm, Ss, Ss, Gd, Ss, Ss, Ss, Gs, Gs, Gs, Gs, Ds, Ds, Gg, Gg, Gs, Ds, Gg, Gs, Re, Gs, Gs, Gs^Es, Gs, Gs, Gs, Gd, Gg, Gs^Edt, Gd, Gs^Edt, Gs^Edt, Gs^Edt, Gs^Edt, Gd, Gs, Gs, Gs, Gd, Gd, Ww, Ww, Ww, Gg, Ch, Ch, Ch, Ch, Gs, Rp, Gs, Gd, Gs, Gs, Gs, Gg
Sm, Sm, Sm, Ss, Ww, Ds, Ww, Ds, Ds, Sm, Sm, Ss, Sm, Ss, Gs, Ss, Gs, Ss, Gs, Ds, Gs, Gs, Gs, Gd, Gd, Gg, Ds, Gg, Gg, Re, Gs, Gs^Es, Gs, Gs^Es, Gs, Gs, Gg, Gs, Gs, Gs^Edt, Gd, Gs^Edt, Gd, Gs, Gs, Gs, Gs, Gll, Gs, Gs, Gs, Gd, Gd, Gg, Gg, Rp, Rp, Rp, Gd, Gg^Vh, Gs, Gs, Gs, Gs, Gs, Gs
Ss, Sm, Ss, Ss, Ss, Ww, Ss, Ww, Ww, Sm, Ss, Sm, Ss, Ss, Ss, Gs, Ss, Gs, Ss, Gs, Ss, Ss, Gs^Vh, Gd, Gd, Gg, Gg, Ds, Gg^Edt, Re, Gs, Gs, Gs, Gs, Gs, Gs, Gg^Efm, Gg, Gs, Gg, Gd, Gd, Gd, Gd, Gg, Gg, Gs, Gs, Gs, Gs, Gg, Gg, Gg, Gg, Gs, Gs, Gs, Gs^Edt, Gd, Gs, Gg^Ve, Gs, Gs, Gs^Edt, Ss, Ss
Sm, Sm, Ss, Ss, Ss, Ss, Wo, Ss, Ss, Ww, Ss, Sm, Sm, Sm, Ss, Gd, Gs, Ss, Ss, Ss, Ss, Ss, Ss, Gs, Gd, Gs, Gg, Gs, Gs, Gs, Ss, Gs, Ss, Ww, Gs, Gs, Gg, Gg^Efm, Gs, Gg^Efm, Gd, Gd, Gg, Gg, Gg, Gg, Gs, Gg^Vh, Gs, Gg, Gg, Gs^Edt, Gs, Gs, Gs, Gs^Edp, Gs, Gs, Gs, Gs, Gs, Gs, Gd, Ss, Sm, Sm
Sm, Ss, Sm, Ss, Ss, Ss, Ss, Ss, Wwr, Ss, Ss, Ss, Ss, Sm, Sm, Ss, Ss, Ss, Sm, Sm, Ss, Gs^Fetd, Ss, Ss, Gg, Ss, Ss, Gs, Gs, Gd, Ss, Ss, Ss, Ww, Ww, Gs, Gg, Gs^Efm, Gs, Gd, Gg, Gg, Gs, Gll, Gll, Gll, Gs, Gd, Gs, Gs, Gs^Edt, Gs, Gs, Gs, Gg^Ve, Gs, Gs, Gs, Gd, Gs, Gs, Gs, Gd, Gd, Sm, Ss
Sm, Ss, Sm, Sm, Sm, Ss, Ww, Ss, Ss, Wwr, Ss, Sm, Ss, Ss, Ss, Ss, Ss, Sm, Ss, Ss, Ss, Ss, Gd, Ss, Ss, Gg, Ss, Ss, Ss, Ss, Ss, Sm, Ss, Sm, Ww, Gs, Ds, Gs, Gs, Gs, Gs, Gs, Gs, Gs, Gs, Gs, Gs, Gs, Gs, Gs, Gs, Gs^Edt, Gs, Gs, Gs, Gs, Gg, Gs, Gs, Gg, Gg, Gs, Gs, Gd, Ss, Ss
