Hhd, Hhd, Hhd, Mm, Mm, Hh, Mm, Hh, Hh, Rb, Hhd, Mm, Mm, Hhd^Em, Hhd^Emf, Mm, Mm, Mm^Xm, Mm, Mm, Mm, Mm
Mm, Mm, Mm, Mm, Mm, Mm, Mm, Mm, Hhd, Rb, Hh, Mm, Mm, Mm, Mm, Mm, Hhd, Mm, Mm, Mm, Mm, Mm
Mm, Mm, Mm, Mm, Mm, Mm, Mm, Mm, Mm, Re, Mm, Mm, Mm, Mm, Mm, Mm, Mm, Mm, Mm, Mm, Hhd, Hh
Hh, Mm, Mm, Mm, Hhd^Em, Hhd^Emf, Hhd^Em, Mm, Mm, Mm, Mm, Mm, Mm, Mm, Mm, Mm, Hhd, Mm, Mm, Mm, Mm, Hh
Hh, Mm, Mm, Hhd, Mm, Mm, Mm, Hh, Hh, Mm, Mm, Mm, Mm, Mm, Mm, Mm, Mm, Mm, Mm, Mm, Hh, Mm
Hh, Hhd, Mm, Mm, Hhd, Mm, Mm, Mm, Mm, Hh, Mm, Mm, Hhd, Mm, Hhd^Em, Mm, Mm, Mm, Mm, Mm, Mm, Hh
Hh, Mm, Mm, Mm, Mm, Hh^Vhh, Mm, Mm, Mm, Mm^Xm, Mm, Hh, Mm, Mm, Hhd^Em, Hhd^Emf, Hh^Em, Mm, Mm, Mm^Xm, Mm, Hh
Hh^Fds, Mm, Mm, Mm, Mm, Mm, Gs, Mm, Mm, Mm, Hh, Mm, Mm, Mm, Mm, Mm, Mm, Hh, Mm, Mm, Hhd, Mm
Gs^Fms, Hh^Fms, Hh, Mm, Gg, Gs, Gd, Hh, Mm, Mm, Mm, Mm, Hh^Fds, Mm, Mm, Mm, Mm, Mm, Mm, Mm, Mm, Hhd
Gg, Gs, Gg, Gg^Efm, Hh, Gg, Gg, Gg, Gg, Hhd^Vhhr, Gs, Hh, Mm, Hh^Fds, Gs^Fms, Mm, Mm, Mm, Gs, Mm, Mm, Hh
Gs^Fds, Gg^Ve, Gg, Hh, Hh^Em, Hh^Fms, Gg^Efm, Gg, Hh^Fds, Gg, Gg, Gd, Gs, Gs^Fms, Gg^Efm, Gg, Gll, Gd, Gg^Efm, Hhd, Hh, Hh^Fds
Gs^Fds, Gd, Gs, Hhd, Hh^Em, Gg^Efm, Hhd, Gs, Hh, Hh, Hh, Gg, Hh^Fds, Gg, Hh^Fds, Gll, Wwr, Ds, Ds, Gg, Gll, Gs^Fms
Gg^Fms, Gg^Fms, Gg, Gs^Vh, Gg^Fms, Hh^Fms, Gs, Hhd, Gs^Es, Gs^Es, Gs^Fms, Hh^Em, Hhd^Emf, Hh^Em, Gll, Gll, Ww, Ss, Ww, Ds, Ww, Gll
Gg, Gg^Efm, Gs^Fms, Gg, Gg, Hh, Gd, Hh^Fms, Gg, Gs^Fms, Gs, Hh^Fms, Hh^Vhh, Gll, Ww^Ewl, Ww^Ewf, Sm, Wwr, Wwr, Ss, Ww, Wwf
Gs, Gs, Gd, Gg, Gg, Gs, Gg, Hh^Fms, Gg, Gs, Gg^Efm, Gs, Gg, Ds, Ss, Sm, Ww^Ewl, Ss, Ss, Sm, Wwr, Sm
Gs, Hh^Em, Hh, Gg^Efm, Gg^Efm, Gs^Fms, Hh^Fms, Gg, Gs^Fms, Gg, Chr, Chr, Chr, Ds, Ds, Ww, Wwf, Ds, Ds, Ww, Ss, Sm
Hh, Hh^Fds, Gg, Hh, Gs, Gs, Gg, Hh^Fms, Gg, Gg, Chr, 2 Khr, Chr, Gg, Gll, Wwf, Gll, Wwf, Ds, Ss, Ds, Ww
Gg, Gs, Gg^Efm, Hh^Fms, Hh^Fms, Hh^Fms, Hh, Gg, Ww, Gll, Gll, Chr, Gg, Gg, Gs^Ecf, Gll, Gs, Gll, Gs, Ds, Gg^Efm, Ds
Ds, Ww, Wwr, Gs, Gs, Gg, Gll, Gll, Ss, Ss, Gll, Gg, Gg, Gs, Gs, Gg^Efm, Gs^Fms, Gs, Hh^Fds, Gg^Efm, Gs, Gg
Ww, Ss, Ww, Ds, Ds, Ds, Ww, Wwf, Wwf, Wwf, Gll, Gs^Vl, Gg, Hh, Gg, Gg, Gg, Gs^Fds, Gs^Fds, Gs^Fms, Hh, Hh
Wwf, Ds, Ss, Ss, Ww^Wkf, Ww^Wkf, Ss, Ds, Ds, Gll, Gd, Gd, Gg, Gg, Ds, Gd, Ds, Gg^Efm, Gg, Gg, Gs, Gs
Gd, Ds, Ds, Ww^Ewl, Ww, Wwr, Sm, Ss, Ds, Gll, Gll, Hh, Hhd, Gg, Gg, Gs^Vc, Gg, Gg, Ds, Gg, Hhd^Em, Hhd^Em
Gg^Fms, Gd, Gll, Ww, Ds, Wwr, Ss, Sm, Ds, Wwf, Gll, Gg, Gg^Efm, Hhd^Em, Gs, Gg, Gg, Gs, Gs, Gg, Hh, Mm
Hh^Fms, Gg, Gg^Efm, Ds, Ss, Ds, Ds, Ds, Ww^Ewl, Wwf, Gll, Gs^Fds, Hhd, Gg, Gs^Es, Hh, Gg, Gs^Vh, Gg, Gg^Efm, Hh^Fms, Mm
Hh, Hh^Fms, Gs, Ds, Ww^Wkf, Ss, Ds, Ss, Ss, Ww, Gll, Gs^Fds, Hh^Fds, Gg, Gg, Gd^Es, Gg, Gg, Gg^Efm, Gg^Efm, Gg, Hh^Fms
Mm, Gs^Fds, Mm, Gd, Gd, Ds, Ww^Wkf, Ss, Ds, Ww^Wkf, Gll, Gg^Efm, Gg^Efm, Hh, Gg^Efm, Gg, Gs, Gg^Efm, Gg, Gs^Fds, Gg, Hh^Fms
Mm, Mm, Mm, Hh^Vhh, Gg^Fms, Gll, Gll, Gll, Ww^Wkf, Ds, Gg, Gg, Gs^Fds, Gg^Efm, Gg, Gg, Ds, Gd, Gs^Vh, Gg, Gs^Fms, Gg
Mm, Mm, Hh^Fds, Hh^Fms, Gg, Gs, Hhd^Em, Gs, Gg, Ds, Gg, Gs, Gd, Gs, Gg, Gg, Gg, Gg, Gg, Gg, Gs^Fds, Gs^Fms
Mm, Hh, Mm, Mm, Mm, Hh^Fds, Hh, Gg, Gg^Efm, Gs, Gg^Efm, Gs^Vc, Gg, Gd, Gg, Gs^Fds, Gs^Fds, Gs^Fds, Gs^Fms, Gs, Gs, Gs
Mm, Hh^Fds, Hh, Mm, Mm, Mm, Mm, Gg, Gs^Fds, Gg^Efm, Gs^Es, Gg, Gg, Gg, Ww^Wkf, Gs, Gs, Gs, Gg, Gg^Efm, Gs^Fms, Gs^Fms
Mm, Mm, Mm, Mm, Mm, Mm, Hh^Fms, Gs^Fds, Gs^Fds, Gd, Gs^Fms, Gd^Es, Gg, Gs, Ww^Wkf, Ww, Ww, Ds, Ds, Gg, Gg, Gg
Hh^Em, Mm, Mm, Mm, Mm, Mm, Gd, Gs^Fds, Gs^Fms, Gs, Gg, Gg, Wwf, Ds, Ds, Ds, Gg, Ww, Gg, Gs, Wwr, Wwr
Hh, Hh^Em, Hh^Fms, Mm, Hh, Gs, Gs, Gg^Fms, Gs, Gs, Gg^Efm, Gg^Efm, Wwf, Wwf, Wwf, Ww, Chr, Chr, Chr, Ww, Ds, Ww
Gs, Gs^Fms, Gd, Hh^Fms, Gg^Fms, Gg^Fms, Gg, Gs, Gg, Gg, Gs^Fds, Gs^Fms, Gs^Fms, Gs^Fms, Gg, Gg, Chr, 1 Khr, Chr, Wwf, Ww, Ds
Gg^Efm, Gs, Gg, Gg, Gg^Efm, Gg^Efm, Gg, Gs^Vh, Gg, Gg, Gg, Gs^Fds, Gg, Gg^Efm, Gg, Gd, Gs, Chr, Gg^Efm, Wwf, Wwf, Wwf
Gg, Gg, Gs^Fms, Gg, Gg, Gg, Gg, Gg, Hh, Gs, Mm, Gg, Gg, Gg, Ds, Gg, Gg, Gg, Gs, Gg, Gg, Gg
Gs^Fds, Gs^Fds, Gs^Fds, Gg, Ch, Ch, Ch, Gg, Mm, Mm, Hh^Fds, Mm, Gg, Ds, Wwr, Wwr, Gs, Gd, Ww^Wkf, Gs, Ds, Gg
Gg, Gg, Gg, Gd, Ch, Kh, Ch, Gs, Mm, Hh^Vhh, Gs^Fms, Gs^Fds, Gd, Ds, Ww, Ds, Ww, Ww, Ww^Wkf, Ds, Ww^Wkf, Ds
Hh, Hh^Vhh, Hh, Gs, Gs, Ch, Gg, Gg^Efm, Gg^Efm, Gg^Efm, Gs, Gg, Wwr, Gs, Gg^Efm, Ds, Ds, Ds, Gd, Gs, Ww, Ww
Mm, Mm, Mm, Gg, Gg, Gg, Gg, Gg, Ds, Ds, Gs, Ds, Ww, Ww, Gg, Gg, Gg, Ww, Gg, Gg, Gg, Gg
