Xu, Xu, Xu, Xu, Xu, Xu, Xu, Xu, Xu, Xu, Xu, Xu, Xu, Ww, Ww, Xu, Xu, Xu, Ww, Ww, Xue, Xu, Xue, Xue, Xue, Xu, Xu, Xu, Xu, Xu
Xu, Xu, Xu, Xu, Xu, Xu, Xu, Xu, Xu, Xu, Xu, Xu, Xu, Ww, Ww, Xu, Xu, Xu, Ww, Ww, Xu, Xue, Uhe, Uhe, Qxua, Xue, Xu, Xu, Xu, Xu
Xu, Xu, Xu, Xu, Xu, Xu, Xu, Xu, Xu, Xu, Xu, Xu, Xu, Xue, Xue, Ww^Bw\r, Uu, Ww^Bw/r, Xu, Xu, Ur, Uue, Uhe, Qxua, Qxua, Xue, Xu, Xu, Xu, Xu
Xu, Xu, Xu, Xu, Xu, Xu, Xu, Xu, Xu, Xu, Uh^Ii, Xu, Uh, Uhe, Uu, Uhe, Uhe, Uue, Uu^Ii, Ur, Uh, Uu^Vud, Cud, Cud, Cud, Xue, Xu, Xu, Xu, Xu
Xu, Xu, Xu, Xu, Xu, Xu, Xu, Xue, Uue, Uu^Vud, Uh^Ii, Uh, Qxua, Uh, Uh, Ur, Xue, Uu, Uhe^Emf, Uu, Xu, Uh^Tf, Xu, 2 Kud, Xu, Xue, Xu, Xu, Xu, Xu
Xu, Xu, Xu, Xu, Xu, Xu, Ur, Ur, Uhe^Ii, Uu^Ii, Xu, Qxua, Xu, Qxua, Xue, Xue, Uu, Uu, Uu^Vu, Uu, Uh, Uh, Xu, Xu, Xu, Xu, Xu, Xu, Xu, Xu
Xu, Xu, Xu, Xu, Uue, Xu, Uue, Urb, Xu, Xu, Xu, Xu, Xu, Xu, Xue, Uh, Xu, Xu, Qxua, Uu, Uh, Xu, Xu, Xu, Xu, Xu, Xu, Xu, Xu, Xu
Xu, Xu, Xu, Xu, Ur, Uue, Uu, Uue, Xu, Xu, Xu, Xue, Xue, Xue, Xue, Ur, Xu, Xu, Ur, Uue, Uu, Uh, Xu, Xu, Xu, Xu, Xu, Xu, Xu, Xu
Xu, Xu, Xu, Xu, Xu, Ur, Xu, Uu^Vud, Uu, Xu, Xu, Uh, Uue, Uue, Xue, Uu, Xu, Xu, Uu, Uu^Vu, Uu, Xu, Xu, Xu, Xu, Xu, Xu, Xu, Xu, Xu
Xu, Xu, Xu, Xu, Xu, Xu, Xu, Xu, Xu, Uh, Uh, Uh, Uu, Uu^Tf, Xue, Uh, Uu, Uu, Urb, Ur, Uu, Xu, Xu, Xu, Xu, Xu, Xu, Xu, Xu, Xu
Xu, Xu, Xu, Xu, Xu, Xu, Xu, Xu, Uu, Ur, Uu, Uu^Vud, Qxua, Uu, Uu, Uu, Uu, Uu, Cud^Ii, Uh^Ii, Uu^Ii, Uue, Xu, Xu, Xu, Xu, Xu, Xu, Xu, Xu
Xu, Xu, Xu, Xu, Uh, Uh, Uue, Uu, Uhe, Uu^Ii, Qxua, Qxua, Xu, Xu, Xu, Xu, Xu, Ur, Uh, Uh, Ur, Uue, Uue, Xu, Xu, Xu, Xu, Xu, Xu, Xu
Xu, Xu, Xu, Xu, Uh, Xu, Uue, Uh, Xu, Uhe, Qxua, Xu, Xu, Xu, Xu, Xu, Xu, Uh, Ur, Ur, Xu, Uu^Vud, Uu, Xu, Xu, Xu, Xu, Xu, Xu, Xu
Xu, Xu, Xu, Xu, Uue, Uu, Uue, Uue, Xu, Uu, Uue, Xu, Xu, Xu, Xu, Xu, Xu, Uh, Qxua, Xu, Xu, Ur, Uu, Xu, Xu, Xu, Xu, Xu, Xu, Xu
Xu, Xu, Xu, Xu, Xu, Uu, Tb^Tf, Uu^Vu, Xu, Uu, Ur, Xu, Cud, Cud, Cud, Xu, Uu, Uu, Uh, Xu, Uu, Uu, Xu, Xu, Xu, Xu, Xu, Xu, Xu, Xu
Xu, Xu, Xu, Xu, Uh, Uh, Uh, Uh, Uu, Uu, Xue, Xu, Xue, 3 Kud, Uh^Emf, Tb^Tf, Uu^Vu, Uu, Uu, Uu, Uu, Uu, Uh, Xu, Xu, Xu, Xu, Xu, Xu, Xu
Xu, Xu, Xu, Xue, Uu^Vud, Uue, Xue, Uu, Ur, Uu, Uu, Xue, Uue, Uh, Uue, Ur, Uh, Uu, Xu, Uhe, Uu, Uu, Uu, Xu, Xu, Xu, Xu, Xu, Xu, Xu
Xu, Xu, Xu, Xue, Xue, Xue, Xue, Xue, Xue, Ur, Uu^Vud, Uu, Urb, Uue, Uue, Uh, Xu, Xu, Xu, Xu, Xu, Uu, Uu, Tb^Tf, Ur, Xu, Xu, Xu, Xu, Xu
Xu, Xu, Xu, Xue, Xue, Xue, Xu, Xue, Xu, Qxu, Uu, Uhe, Uu, Qxu^Bs/, Xu, Xu, Xu, Xu, Xu, Xu, Xu, Xu, Xu, Uh, Uh, Xu, Xu, Xu, Xu, Xu
Xu, Xu, Xu, Xu, Xu, Xu, Xu, Xu, Xu, Qxua, Uu^Ii, Uu, Uh^Ii, Xu, Xu, Xu, Xu, Xu, Xu, Xu, Xu, Xu, Uh, Uu^Vu, Uue, Xu, Xu, Xu, Xu, Xu
Xu, Xu, Xu, Xu, Xu, Xu, Xu, Xu, Xu, Qxua, Uu, Uu^Ii, Uh^Emf, Xu, Xu, Xu, Xu, Xu, Xu, Xu, Xu, Uh, Xue, Uue^Ii, Uu, Xu, Uh, Xu, Xu, Xu
Xu, Xu, Xu, Xu, Xu, Xu, Uue, Xu, Uu, Uh, Uh, Uu^Vu, Uu, Tb^Tf, Uue, Xu, Xu, Xu, Xu, Xu, Xu, Xu, Xue, Uu, Cud, Uu, Uu, Uue, Xu, Xu
Xu, Xu, Xu, Xu, Xu, Xu, Uue, Uu, Xu, Uh, Xu, Uh, Uh, Uu, Uu, Urb, Qxu, Xu, Xu, Xu, Xue, Xue, Qxu, Tb^Tf, Uhe^Emf, Uu, Xu, Xu, Xu, Xu
Xu, Xu, Xu, Xu, Xu, Xu, Uue, Xu, Xu, Xu, Xu, Xu, Xu, Uh, Uh^Ii, Uu, Xu, Qxua, Xue, Xue, Xu, Qxua, Uu^Vud, Uhe, Uh, Xu, Xu, Xu, Xu, Xu
Xu, Xu, Xu, Xu, Xu, Xu, Uu, Uu, Tb^Tf, Xu, Xu, Xu, Xu, Uhe, Uh, Uu, Uu^Vu, Uue, Uue, Xu, Uue, Ur, Uhe, Uhe, Xu, Xu, Xu, Xu, Xu, Xu
Xu, Xu, Xu, Xu, Xu, Xu, Uu, Urb, Uh, Xu, Xu, Xu, Xu, Uh, Uh, Ur, Ur, Uu, Uu, Uue, Uu, Uue, Xu, Xu, Xu, Xu, Xu, Xu, Xu, Xu
Xu, Xu, Xu, Xu, Xu, Xu, Xu, Uh, Xu, Xu, Xu, Xu, Uue, Uu, Uh, Qxua, Qxua, Uh, Cud, Uu, Xu, Xu, Xu, Xu, Xu, Xu, Xu, Xu, Xu, Xu
Xu, Xu, Xu, Xu, Xu, Xu, Xu, Xu, Xu, Xu, Xu, Xu, Uh, Uu, Xu, Xu, Xu, Tb^Tf, 1 Kud, Uh, Xu, Xu, Xu, Xu, Xu, Xu, Xu, Xu, Xu, Xu
Xu, Xu, Xu, Xu, Xu, Xu, Xu, Xu, Xu, Xu, Xu, Xu, Xu, Xu, Xu, Xu, Xu, Cud, Ur, Cud, Xu, Xu, Xu, Xu, Xu, Xu, Xu, Xu, Xu, Xu
Xu, Xu, Xu, Xu, Xu, Xu, Xu, Xu, Xu, Xu, Xu, Xu, Xu, Xu, Xu, Xu, Xu, Xu, Ur, Xu, Xu, Xu, Xu, Xu, Xu, Xu, Xu, Xu, Xu, Xu
