border_size=1
usage=map

Xu          , Xu          , Xu          , Xu          , Xu          , Xu          , Xu          , Xu          , Wo          , Wo          , Xu          , Wo          , Wo          , Xu          , Xu          , Xu          , Xu          , Xu          , Xu          , Xu          , Xu          , Xu          
Xu          , Cud         , 2 Kud       , Xu          , Xu          , Xu          , Xu          , Xu          , Ww          , Xu          , Xu          , Ww          , Ww          , Xu          , Xu          , Xu          , Xu          , Xu          , Xu          , Xu          , Xu          , Xu          
Xu          , Cud         , Cud         , Cud         , Uh          , Xu          , Uu          , Xu          , Xu          , Ww^Bw\      , Uu          , Ww^Bw/      , Xu          , Xu          , Xu          , Xu          , 3 Kud       , Xu          , Xu          , Xu          , Xu          , Xu          
Xu          , Uu          , Xu          , Uu          , Uh          , Uh          , Uu          , Xu          , Qxu         , Xu          , Uu          , Xu          , Xu          , Xu          , Xu          , Cud         , Cud         , Cud         , Uu          , Xu          , Xu          , Xu          
Xu          , Uu          , Qxu         , Uu          , Uu          , Uu          , Uu          , Qxu         , Uh          , Qxu         , Uu          , Xu          , Xu          , Xu          , Xu          , Uu          , Uu          , Uu          , Uu          , Xu          , Xu          , Xu          
Xu          , Uu          , Qxu         , Xu          , Xu          , Uu^Vud      , Uu          , Uh          , Uu          , Uu          , Uu          , Xu          , Xu          , Ur          , Ur          , Xu          , Uh          , Uu          , Uu          , Xu          , Xu          , Xu          
Xu          , Uu          , Uu          , Xu          , Xu          , Uh          , Ur          , Ur          , Xu          , Xu          , Uu          , Qxu         , Qxu         , Uu          , Ur          , Xu          , Xu          , Xu          , Xu          , Uu^Vud      , Xu          , Xu          
Xu          , Uu          , Uu          , Xu          , Uu          , Uu          , Ur          , Xu          , Xu          , Xu          , Uu          , Uu          , Uu          , Uu          , Uu          , Xu          , Xu          , Xu          , Ur          , Uu          , Xu          , Xu          
Xu          , Uu          , Xu          , Xu          , Uu          , Xu          , Uu          , Xu          , Xu          , Xu          , Uh          , Uu          , Xu          , Uu          , Xu          , Xu          , Xu          , Xu          , Ur          , Uu          , Uu          , Xu          
Xu          , Xu          , Xu          , Xu          , Uu          , Uu          , Xu          , Xu          , Xu          , Xu          , Xu          , Ur          , Xu          , Xu          , Uu          , Xu          , Xu          , Xu          , Xu          , Ur          , Ur          , Xu          
Xu          , Xu          , Xu          , Ur          , Uu          , Xu          , Xu          , Uu^Vud      , Uu          , Xu          , Ur          , Ur          , Xu          , Uu          , Ur          , Uu          , Uh          , Xu          , Xu          , Xu          , Uu          , Xu          
Xu          , Xu          , Xu          , Ur          , Ur          , Qxu         , Uu          , Uu          , Uu          , Xu          , Xu          , Xu          , Uu^Vu       , Ur          , Qxu         , Ur          , Uu          , Uu          , Uu          , Xu          , Uu          , Xu          
Xu          , Xu          , Xu          , Xu          , Xu          , Uu          , Uu          , Qxu         , Uu          , Uu          , Uu          , Uu          , Uu          , Uh          , Xu          , Qxu         , Uu          , Xu          , Xu          , Uu^Vud      , Xu          , Xu          
Xu          , Xu          , Xu          , Xu          , Uu^Vud      , Uu          , Uu          , Qxu         , Xu          , Uh          , Xu          , Xu          , Xu          , Xu          , Xu          , Xu          , Uu          , Xu          , Xu          , Xu          , Xu          , Xu          
Xu          , Xu          , Xu          , Xu          , Uu          , Qxu         , Uu          , Xu          , Xu          , Xu          , Xu          , Xu          , Xu          , Xu          , Xu          , Xu          , Uu          , Xu          , Ur          , Ur          , Ur          , Xu          
Xu          , Xu          , Uu          , Uu          , Uu          , Xu          , Uu          , Xu          , Xu          , Xu          , Uu          , Xu          , Xu          , Xu          , Uu^Vud      , Xu          , Uu          , Xu          , Uu          , Qxu         , Uu          , Xu          
Xu          , Uu          , Qxu         , Uh          , Uu          , Xu          , Uu          , Xu          , Xu          , Uu          , Uu          , Uu          , Qxu         , Xu          , Uu          , Xu          , Ur          , Xu          , Ur          , Qxu         , Uu          , Xu          
Xu          , Uu          , Qxu         , Uu^Vu       , Xu          , Xu          , Uu          , Xu          , Uu^Vud      , Ur          , Xu          , Uu          , Uu          , Qxu         , Ur          , Xu          , Xu          , Ur          , Uh          , Qxu         , Uu          , Xu          
Xu          , Uu          , Qxu         , Xu          , Xu          , Xu          , Uu          , Xu          , Xu          , Ur          , Ur          , Xu          , Uh          , Ur          , Uh          , Ur          , Qxu         , Xu          , Xu          , Xu          , Ur          , Xu          
Xu          , Uu          , Uu^Vud      , Uu          , Xu          , Xu          , Uu          , Uu          , Xu          , Xu          , 1 Kud       , Xu          , Xu          , Ur          , Xu          , Qxu         , Uu          , Uu          , Ur          , Uh          , Ur          , Xu          
Xu          , Xu          , Xu          , Uu          , Xu          , Uh          , Uh          , Uh          , Xu          , Cud         , Ur          , Cud         , Xu          , Uu          , Uu          , Uu          , Xu          , Uu          , Xu          , Ur          , Xu          , Xu          
Xu          , Xu          , Xu          , Xu          , Xu          , Xu          , Xu          , Xu          , Xu          , Xu          , Uu          , Xu          , Xu          , Xu          , Xu          , Xu          , Xu          , Xu          , Xu          , Xu          , Xu          , Xu          
