Xu, Xu, Xu, Xu, Xu, Xu, Xu, Xu, Xu, Xu, Xu, Xu, Xu, Xu, Xu, Xu, Xu, Xu, Xu^Efs, Xu, Xu, Xu, Xu, Xu, Xu, Xu, Xu, Xu, Xu, Xu, Xu
Xu, Xu, Xu, Xu, Xu, Xu, Xu, Xu, Xu, Xu, Xu, Xu, Xu, Xu, Qxua, Xu^Efs, Xu^Efs, Xu, Uue, Uhe, Uhe^Tf, Xu, Uh, Xu^Efs, Xu^Efs, Xu, Xu, Xu, Xu, Xu, Xu
Xu, Xu, Xu, Xu, Xu, Xu, Xu, Xu, Xu, Xu, Xu, Xu, Qxua, Qxua, Uu, Ur, Ur, Ur, Uue, Uu, Uue^Emf, Uu^Emf, Uh, Uhe^Tf, Cud, Xu, Xu, Xu, Xu, Xu, Xu
Wo, Xu, Xu, Xu, Xu, Xu, Xu, Xu, Xu, Xu, Xu, Qxua, Uhe^Tf, Uhe^Emf, Uue, Uu, Xu, Uue, Qxua, Qxua, Ur, Uu, Ur, Cud, 2 Kud, Cud, Xu, Xu, Xu, Xu, Xu
Wo, Ww, Wwr, Xu, Xu, Xu, Xu, Xu, Xu, Xu, Xu, Qxua, Uue^Emf, Ur, Uu^Vud, Xu, Uu^Vud, Xu^Efs, Uue, Uu, Uu, Ur, Uh, Cud, Cud, Cud, Xu, Xu, Xu, Xu, Xu
Qxua, Ww, Uh, Uu, Xu, Xu, Xu, Xu, Xu, Xu, Xu, Qxua, Uh, Ur, Uh, Xu, Uh, Ur, Uue^Emf, Uue, Xu, Xu, Qxua, Uhe, Ur, Uh^Emf, Xu^Efs, Xu, Xu, Xu, Xu
Xu, Qxua, Uhe, Ur, Xu, Xu, Xu, Xu, Xu, Xu, Xu, Xu, Qxua, Qxua^Bs|, Qxua, Xu, Uh, Uu, Uh^Tf, Uhe, Xu, Xu, Qxua, Ur, Uu^Vud, Uh, Qxua, Xu, Xu, Xu, Xu
Xu, Xu, Uue^Emf, Uue, Xu, Xu, Xu, Xu, Xu, Xu, Xu^Efs, Xu^Efs, Uue, Ur, Uu, Qxua, Qxua^Bs/, Ur, Xu, Xu, Xu^Efs, Qxua, Uh^Tf, Uue, Uu, Uh, Qxua, Xu, Xu, Xu, Xu
Xu, Xu, Ur, Ww, Xu^Efs, Xu^Efs, Xu, Xu, Qxua, Xu, Wwr, Uh, Uue^Tf, Uh, Uu, Ur, Uh, Qxua, Xu, Xu^Efs, Uhe, Uhe^Tf, Uu^Tf, Uu, Xu, Qxua, Xu, Xu, Xu, Xu, Xu
Xu, Xu, Uue, Uh^Tf, Uhe^Tf, Qxua, Qxua, Qxua, Uh, Uhe^Emf, Ur, Uue, Uu, Uh^Tf, Uu^Vud, Uu, Ur, Qxua, Ur, Uu^Vud, Uue, Uue^Emf, Qxua, Xu, Xu, Xu, Xu, Xu, Xu, Xu, Xu
Qxua, Xu^Efs, Uh, Ur, Qxua, Xu, Xu, Uu^Vud, Ur, Uu, Uu^Tf, Uhe, Uh, Uu, Uh, Uu, Xu, Qxua^Bs\, Ur, Uue, Uh, Qxua, Xu, Xu, Xu, Xu, Xu, Xu, Xu, Xu, Xu
Wo, Qxua, Ur, Ur, Uh, Qxua, Qxua, Qxua, Uu, Ww, Uue^Tf, Uhe^Tf, Qxua, Uh, Xu, Xu, Xu, Qxua, Uu, Uh, Xu, Xu, Xu, Xu, Xu, Xu, Xu, Xu, Xu, Xu, Xu
Ww, Uh, Uhe, Uu, Ur, Ww, Uh, Uue, Uu, Uh, Uue, Qxua, Xu, Xu, Xu, Xu, Xu, Xu, Xu, Xu, Xu, Xu, Xu, Xu, Xu, Xu, Xu, Xu, Xu, Xu, Xu
Wwr, Uue, Uhe^Emf, Uh^Tf, Uu, Uu, Uh, Uu^Vud, Uh^Tf, Ur, Ww, Qxua, Xu^Efs, Xu, Xu, Xu, Xu, Xu, Xu, Xu, Xu, Xu, Xu, Xu, Xu, Xu, Xu, Xu, Xu, Xu, Xu
Uh, Uue, Ur, Ur, Xu, Ur, Wwr, Ur, Uu, Ur, Qxua, Qxua, Qxua, Xu^Efs, Xu, Xu, Xu, Xu, Xu, Xu, Xu, Xu, Xu, Xu, Xu, Xu, Xu, Xu, Xu, Xu, Xu
Xu, Uh, Uu^Vud, Wwr, Xu^Efs, Uh, Uhe, Uu, Ur, Ur, Uu, Uu, Uhe, Uu^Vud, Ww, Xu, Wo, Xu^Efs, Xu^Efs, Xu, Xu, Xu, Xu, Xu, Xu, Xu, Xu, Xu, Xu, Xu, Xu
Xu, Xu, Xu, Xu, Qxua, Uhe, Uue^Emf, Ur, Uh, Uh, Uh, Ur, Ur^Tf, Uue, Uu, Wwr, Qxua, Uu, Uu, Xu, Xu, Xu, Xu, Xu, Xu, Xu, Xu, Xu, Xu, Xu, Xu
Xu, Xu, Xu, Xu, Qxua, Uhe, Uue, Uue, Uh^Tf, Uhe^Emf, Xu, Uu, Uu^Vud, Ww, Xu, Qxua, Ww, Qxua, Uu, Ww, Xu, Xu, Xu, Xu, Xu, Xu, Xu, Xu, Xu, Xu, Xu
Xu, Xu, Xu, Xu, Xu, Uh, Ur, Uu, Uhe^Tf, Qxua, Xu, Xu, Xu, Xu, Xu, Uh, Ur, Ur, Xu, Xu, Xu^Efs, Xu^Efs, Xu, Xu, Xu^Efs, Xu, Xu, Xu, Xu, Xu, Xu
Xu, Xu, Xu, Xu, Cud, Cud, Cud, Uu, Uhe, Qxua, Xu^Efs, Xu, Xu, Xu, Xu, Uh, Uu, Qxua, Xu, Xu^Efs, Ww, Uu, Uhe, Wo, Uh, Qxua, Qxua, Xu, Xu, Xu, Xu
Xu, Xu, Xu, Xu, Cud, Kud, Cud, Uu, Uh, Uhe, Uu^Vud, Xu, Xu, Xu, Xu, Ww, Ww, Qxua, Ur, Wo, Uh, Uh, Wo, Ww, Uh, Uu, Qxua, Xu, Xu, Xu, Xu
Xu, Xu, Xu, Xu, Uh, Cud, Uh, Uue, Uu, Ww, Uh, Xu, Qxua, Xu, Ww, Uue, Uu, Ur^Emf, Uhe, Uue, Xu, Xu, Ww, Uhe, Ur, Uh, Xu, Xu, Xu, Xu, Xu
Xu, Xu, Xu, Xu, Xu, Uh, Uue, Uue, Uh, Uu, Uh, Qxua, Ur, Uu, Uhe, Uu, Uh, Uhe^Tf, Uue^Emf, Qxua, Xu, Xu, Xu, Uh, Ww, Ur, Xu, Xu, Xu, Xu, Xu
Xu, Xu, Xu, Xu, Xu, Xu, Xu^Efs, Uu, Uue^Emf, Uue, Uue, Ur, Wwr, Uu, Xu, Uu, Uu, Ww, Uu, Uu, Uh, Xu^Efs, Xu^Efs, Uue, Wo, Ww, Xu, Xu, Xu, Xu, Xu
Xu, Xu, Xu, Xu, Xu, Qxua, Qxua, Uh^Tf, Ur, Ww, Uu, Uh, Xu, Xu, Xu, Xu, Xu, Xu, Xu, Ww, Ww, Uu, Uh, Wwr, Wo, Uh, Ww, Xu^Efs, Xu^Efs, Xu, Xu
Xu, Xu, Xu, Xu, Xu, Qxua, Uh, Uh, Uh^Emf, Ur, Qxua, Qxua, Xu, Xu, Xu, Xu, Xu, Xu, Xu, Wo, Wo, Wo, Uu, Uue^Emf, Uu, Ur, Ww, Uh, Ww, Ww, Wo
Xu, Xu, Uu, Uue^Tf, Wwr, Uh, Uh^Tf, Uu, Uu, Ur, Qxua, Xu, Xu, Xu, Xu, Xu, Xu, Xu, Xu, Xu, Xu, Xu, Xu, Ww, Uue, Ur, Wwr, Ww, Chw, Chw, Chw
Wo, Ww, Uh, Ur, Uhe, Uh, Xu^Efs, Uu, Uue, Uue, Xu, Xu, Xu, Xu, Xu, Xu, Xu, Xu, Xu, Xu, Xu, Xu, Xu, Xu, Xu, Wwr, Ww, Ur, Chw, 3 Khw, Chw
Wo, Wwr, Xu, Xu, Xu, Xu^Efs, Wwr, Ur, Uu^Vu, Uue^Emf, Xu^Efs, Xu, Xu, Xu, Xu, Xu, Xu, Xu, Xu, Xu, Xu, Xu, Xu, Xu, Xu, Wwr, Uh, Ww, Ww, Chw, Wo
Xu, Xu, Xu, Xu, Qxua, Uue, Ur, Ur, Uh^Tf, Ur, Qxua, Xu, Xu, Xu, Xu, Xu, Xu, Xu, Xu, Xu, Xu, Xu, Xu, Xu, Xu, Xu, Xu, Uu, Xu, Wo, Wo
Xu, Xu, Xu, Xu, Xu, Uue, Cud, Ur, Uh^Emf, Uh, Qxua, Xu, Xu, Xu, Xu, Xu, Xu, Xu, Xu, Xu, Xu, Xu, Xu, Xu, Xu, Xu, Xu, Xu, Xu, Xu, Xu
Xu, Xu, Xu, Xu, Xu, Cud, 1 Kud, Cud, Xu, Qxua, Xu, Xu, Xu, Xu, Xu, Xu, Xu, Xu, Xu, Xu, Xu, Xu, Xu, Xu, Xu, Xu, Xu, Xu, Xu, Xu, Xu
Xu, Xu, Xu, Xu, Xu, Cud, Cud, Cud, Xu, Xu, Xu, Xu, Xu, Xu, Xu, Xu, Xu, Xu, Xu, Xu, Xu, Xu, Xu, Xu, Xu, Xu, Xu, Xu, Xu, Xu, Xu
Xu, Xu, Xu, Xu, Xu, Ww, Ww, Ww, Xu, Xu, Xu, Xu, Xu, Xu, Xu, Xu, Xu, Xu, Xu, Xu, Xu, Xu, Xu, Xu, Xu, Xu, Xu, Xu, Xu, Xu, Xu
Xu, Xu, Xu, Xu, Xu, Ww, Ww, Ww, Xu, Xu, Xu, Xu, Xu, Xu, Xu, Xu, Xu, Xu, Xu, Xu, Xu, Xu, Xu, Xu, Xu, Xu, Xu, Xu, Xu, Xu, Xu
