Xu, Xu, Xu, Xu, Xu, Xu, Xu, Xu, Xu, Xu, Xu, Xu, Xue, Xue, Xue, Xu, Xu, Xu, Xu, Xu, Xu, Xu, Xu, Xu, Xue, Xu, Xu, Xu, Xu, Xu, Xu
Xu, Xu, Xu, Xu, Xu, Xu, Xu, Xu, Xu, Xu, Xue, Xu, Uh, Uue, Uh^Edt, Xu, Uh^Emf, Xu, Uu, Ur, Ur^Ii, Xu, Cud, Xu, Xue, Xu, Xu, Xu, Xu, Xu, Xu
Xu, Xu, Xu, Xu, Xu, Xu, Xu, Xu, Xu, Xu, Xue, Uue, Qxua, Qxua, Uu, Ur, Uu, Tb^Tf, Uh^Emf, Uh^Emf, Xue, Uu, Cud, Cud, Cud, Xue, Xu, Xu, Xu, Xu, Xu
Xu, Xu, Xu, Xu, Xu, Xu, Xu, Xu, Xu, Xu, Xue, Uh, Qxua, Uh, Uh, Uh, Xu, Uh^Emf, Xue, Xue, Uu^Ii, Uhe, Uu^Vu, Xu, Cud, 2 Kud, Xu, Xu, Xu, Xu, Xu
Xu, Xu, Xu, Xu, Xu, Xu, Xu, Xu, Xu, Xu, Xu, Uu, Tb^Tf, Ur, Uu^Vud, Xu, Xu, Xu, Uu^Ii, Uu^Ii, Uhe, Ur, Ur, Cud, Cud^Edt, Xu, Xu, Xu, Xu, Xu, Xu
Xu, Xu, Xu, Xu, Xu, Xu, Xu, Xu, Xu, Xu, Xu, Xu, Xue, Ur, Xue, Xu, Xu, Uu, Uu, Uhe, Xu, Xue, Uu, Uu^Edt, Urb, Cud, Xu, Xu, Xu, Xu, Xu
Xu, Xu, Xu, Xu, Xu, Xu, Xu, Xu, Xu, Xu, Xu, Xu, Xu, Qxu^Bs|, Qxe, Xue, Xue, Uu, Uh, Xu, Xu, Xue, Uh^Tf, Uu^Edt, Uu^Vud, Xu, Xu, Xu, Xu, Xu, Xu
Wo, Xu, Xu, Xu, Xu, Xu, Xu, Xu, Xu, Xu, Xu, Xu, Uue, Uue, Uu^Ii, Qxu, Qxu^Bs/, Uu, Xu, Xu, Xue, Xue, Uue, Ur^Edt, Xu, Xu, Xu, Xu, Xu, Xu, Xu
Ww, Uu, Ww, Xu, Xu, Xu, Xu, Xue, Xue, Xu, Ww, Uh, Ur, Uh^Ii, Uue, Ur, Uh, Qxe, Xu, Xue, Xue, Xue, Uue, Ur^Ii, Xu, Xu, Xu, Xu, Xu, Xu, Xu
Xu, Ww, Uh, Uu, Xu, Xu, Xu, Xue, Uh, Xue, Ur, Uu, Ur^Ii, Uh^Ii, Uu^Vud, Ur, Ur, Qxe, Ur, Uu^Vud, Uu^Edt, Uue, Ur^Ii, Ur^Ii, Xu, Xu, Xu, Xu, Xu, Xu, Xu
Xu, Xu, Uh, Uu, Xu, Xu, Xu, Uu^Vud, Uue, Uh, Uhe, Ur, Uhe, Uu, Uhe, Uu, Uu, Qxu^Bs\, Ur, Uhe, Uu^Emf, Uu^Edt, Xue, Xue, Xu, Xu, Xu, Xu, Xu, Xu, Xu
Xu, Xu, Uh, Uu, Uu, Xu, Xu, Xu, Uh, Uh, Uhe, Uu, Uu, Uhe, Xu, Xu, Qxe, Qxe, Uu, Tb^Tf, Xu, Xue, Xu, Xu, Xu, Xu, Xu, Xu, Xu, Xu, Xu
Xu, Xu, Uu, Uu, Uu, Uh, Uh, Uu, Uu, Uh^Ii, Uu, Uh^Ii, Uh, Xu, Xu, Xu, Xu, Xu, Xu, Xu, Xu, Xu, Xu, Xu, Xu, Xu, Xu, Xu, Xu, Xu, Xu
Xu, Xu, Uu, Xu, Xu, Uu, Uh, Uu^Vud, Urb, Uu, Uh, Uu, Xu, Xu, Xue, Xu, Xu, Xu, Xu, Xu, Xu, Xu, Xu, Xu, Xu, Xu, Xu, Xu, Xu, Xu, Xu
Xu, Xu, Uh, Uu, Uh, Urb, Uh, Urb, Uhe, Uu, Xue, Xue, Xue, Xue, Xue, Xue, Xu, Xu, Xu, Xu, Xu, Xu, Xu, Xu, Xu, Xu, Xu, Xu, Xu, Xu, Xu
Xu, Xu, Uu^Vud, Uh, Uh, Uh, Uh^Ii, Uu, Uu, Ur, Uue, Uue, Uh, Uu^Vud, Ww, Xue, Uu, Ww, Xu, Xu, Xu, Xu, Xu, Xu, Xu, Xu, Xu, Xu, Xu, Xu, Xu
Xu, Xu, Xu, Xu, Xu, Uh^Ii, Uu, Uu^Vu, Uhe, Uh, Uh, Ur, Uu, Uu, Ww, Wo, Xu, Uu, Uu, Xu, Xu, Xu, Xu, Xu, Xu, Xu, Xu, Xu, Xu, Xu, Xu
Xu, Xu, Xu, Xu, Xue, Uue, Uh^Ii, Uhe, Uh, Uh, Xu, Uu, Uu^Vud, Uh, Xu, Xu, Ww, Xu, Wo, Ww, Xu, Xu, Ww, Xu, Uue, Xu, Xu, Xu, Xu, Xu, Xu
Xu, Xu, Xu, Xu, Xue, Uh^Ii, Uu, Ur, Uh, Uh, Xue, Xu, Xu, Xu, Xu, Xu, Ww, Uu, Xu, Xu, Xu, Xu, Uue, Uue, Uhe, Xu, Xu, Xu, Xu, Xu, Xu
Xu, Xu, Xu, Xu, Cud, Cud, Uu^Vud, Uu, Uue, Uh, Xue, Xu, Xu, Xu, Xu, Xu, Uue, Xu, Xu, Uu, Ww, Uue, Xu, Wo, Xu, Xu, Xu, Xu, Xu, Xu, Xu
Xu, Xu, Xu, Xu, Kud, Xu, Uh, Uue, Uh, Uh^Ii, Uu^Vud, Xue, Xu, Xu, Xue, Wo, Uue, Xu, Uu, Wo, Xu, Xu, Uu, Ww, Uu, Uu, Wo, Xu, Xu, Xu, Xu
Xu, Xu, Xu, Ww, Cud, Xu, Uu^Vu, Uue, Uh, Ww, Uhe, Xue, Xue, Xue, Ww, Uu, Wo, Ww, Uhe, Uu, Xu, Xu, Ww, Xu, Uu, Xu, Xu, Xu, Xu, Xu, Xu
Xu, Xu, Xu, Xue, Xue, Cud, Uu, Uh, Uhe, Uhe, Uh, Xue, Ww, Uu, Uh, Uu, Xu, Xu, Xu, Xu, Xu, Xu, Xu, Xu, Wo, Uue, Xu, Xu, Xu, Xu, Xu
Xu, Xu, Xu, Xu, Xu, Xue, Uu, Ur, Uu, Uh^Ii, Uue, Uue, Wo, Uu, Xu, Uu, Wo, Wo, Uu, Xu, Xu, Xu, Xu, Uu, Wo, Wo, Xu, Xu, Xu, Xu, Xu
Xu, Xu, Xu, Xu, Xu, Xu, Uu, Uue, Uue, Uu, Uh, Uhe, Xu, Xu, Xu, Xu, Xu, Xu, Xu, Ww, Xu, Xu, Xu, Ww, Wo, Uh^Ii, Ww, Xu, Xu, Xu, Wo
Xu, Xu, Xu, Xu, Xu, Xu, Uu, Uhe, Uh, Uue, Xue, Xu, Xu, Xu, Xu, Xu, Xu, Xu, Xu, Wo, Wo, Wo, Ww, Xu, Xu, Uu, Ww^Vm, Uu, Ww, Xu, Wo
Xu, Xu, Uu, Wo, Uu, Uu, Uu, Uhe, Ur, Uu^Vud, Xue, Xu, Xu, Xu, Xu, Xu, Xu, Xu, Xu, Xu, Xu, Xu, Xu, Ww, Uh, Uu, Xu, Ww, Chw, Chw, Chw
Wo, Ww, Uhe, Ww, Uu, Uh, Ur, Uu, Uu, Uu, Xue, Xu, Xu, Xu, Xu, Xu, Xu, Xu, Xu, Xu, Xu, Xu, Xu, Xu, Xu, Xu, Ww^Vm, Uue, Chw, 3 Khw, Wo
Wo, Ww, Xu, Xu, Xu, Xu, Uh, Uue, Uu^Vu, Ur, Xue, Xu, Xu, Xu, Xu, Xu, Xu, Xu, Xu, Xu, Xu, Xu, Xu, Xu, Xu, Xu, Uh, Ww, Chw, Wo, Wo
Xu, Xu, Xu, Xu, Xu, Xu, Uue, Uue, Ww, Qxua, Xue, Xu, Xu, Xu, Xu, Xu, Xu, Xu, Xu, Xu, Xu, Xu, Xu, Xu, Xu, Uu, Xu, Uue, Xu, Wo, Wo
Xu, Xu, Xu, Xu, Xu, Xu, Ur, Ur, Ur, Qxua, Xu, Xu, Xu, Xu, Xu, Xu, Xu, Xu, Xu, Xu, Xu, Xu, Xu, Xu, Xu, Wo, Xu, Xu, Xu, Xu, Xu
Xu, Xu, Xu, Xu, Xu, Cud, Cud, Cud, Xu, Xu, Xu, Xu, Xu, Xu, Xu, Xu, Xu, Xu, Xu, Xu, Xu, Xu, Xu, Xu, Xu, Xu, Xu, Xu, Xu, Xu, Xu
Xu, Xu, Xu, Xu, Cud, Cud, Cud, Xu, Xu, Xu, Xu, Xu, Xu, Xu, Xu, Xu, Xu, Xu, Xu, Xu, Xu, Xu, Xu, Xu, Xu, Xu, Xu, Xu, Xu, Xu, Xu
Xu, Xu, Xu, Xu, Ww, 1 Kud, Ww, Xu, Xu, Xu, Xu, Xu, Xu, Xu, Xu, Xu, Xu, Xu, Xu, Xu, Xu, Xu, Xu, Xu, Xu, Xu, Xu, Xu, Xu, Xu, Xu
Xu, Xu, Ww, Ww, Ww, Ww, Xu, Xu, Xu, Xu, Xu, Xu, Xu, Xu, Xu, Xu, Xu, Xu, Xu, Xu, Xu, Xu, Xu, Xu, Xu, Xu, Xu, Xu, Xu, Xu, Xu
