Xu, Xu, Xu, Xu, Xu, Xu, Xu, Xu, Xu, Xu, Xu, Xu, Xu, Xu, Xu, Xu, Xu, Xu, Xu, Xu, Xu, Xu, Xu, Xu, Xu, Xu, Xu, Xu, Xu, Xu, Xu
Xu, Xu, Xu, Xu, Xu, Xu, Xu, Xu, Xu, Xu, Xu, Xu, Xu, Xu, Xu, Xu, Xu, Xu, Uu, Qxu, Qxu, Xu, Uh, Xu, Xu, Xu, Xu, Xu, Xu, Xu, Xu
Xu, Xu, Xu, Xu, Xu, Xu, Xu, Xu, Xu, Xu, Xu, Xu, Xu, Xu, Uu, Ur, Ur, Ur, Uu, Uu, Uu, Uu, Uh, Cud, Cud, Xu, Xu, Xu, Xu, Xu, Xu
Wo, Xu, Xu, Xu, Xu, Xu, Xu, Xu, Xu, Xu, Xu, Xu, Qxu, Uh, Uu, Uu, Xu, Uu, Xu, Xu, Ur, Uu, Ur, Cud, Cud, 2 Kud, Xu, Xu, Xu, Xu, Xu
Ww, Wo, Wwr, Xu, Xu, Xu, Xu, Xu, Xu, Xu, Xu, Qxu, Uu, Ur, Uu^Vud, Xu, Uu^Vud, Xu, Uu, Uu, Uu, Ur, Uh, Uh, Uh, Cud, Xu, Xu, Xu, Xu, Xu
Qxu, Ww, Uh, Uu, Xu, Xu, Xu, Xu, Xu, Xu, Xu, Xu, Uh, Ur, Uh, Xu, Uh, Ur, Uu, Uu, Xu, Uh, Xu, Xu, Ur, Cud, Xu, Xu, Xu, Xu, Xu
Xu, Qxu, Uh, Ur, Xu, Xu, Xu, Xu, Xu, Xu, Xu, Xu, Qxu, Qxu^Bs|, Qxu, Xu, Uh, Uu, Uh, Uh^Em, Xu, Xu, Xu, Ur, Uu^Vud, Uh, Xu, Xu, Xu, Xu, Xu
Xu, Xu, Uu, Uu, Xu, Xu, Xu, Xu, Xu, Xu, Xu, Xu, Uu, Ur, Uu, Qxu, Qxu^Bs/, Ur, Xu, Xu, Xu, Xu, Uh, Uu, Uu, Uh, Xu, Xu, Xu, Xu, Xu
Xu, Xu, Ur, Ww, Xu, Xu, Xu, Xu, Xu, Xu, Wwr, Uh, Uu, Uh, Uu, Ur, Uh, Qxu, Xu, Xu, Xu, Uh, Uu, Uu, Xu, Xu, Xu, Xu, Xu, Xu, Xu
Xu, Xu, Uu, Uh, Qxu, Xu, Xu, Xu, Uh, Uh, Ur, Uu, Uu, Uh, Uu^Vud, Uu, Ur, Qxu, Ur, Uu^Vud, Uu, Uu, Qxu, Xu, Xu, Xu, Xu, Xu, Xu, Xu, Xu
Qxu, Xu, Uh, Ur, Qxu, Xu, Xu, Uu^Vud, Ur, Uu, Uu, Uh, Uh, Uu, Xu, Uu, Xu, Qxu^Bs\, Ur, Uu, Uh, Qxu, Xu, Xu, Xu, Xu, Xu, Xu, Xu, Xu, Xu
Wo, Qxu, Ur, Ur, Xu, Qxu, Qxu, Qxu, Uu, Ww, Uu, Uu, Qxu, Xu, Xu, Xu, Qxu, Qxu, Uu, Uh, Xu, Xu, Xu, Xu, Xu, Xu, Xu, Xu, Xu, Xu, Xu
Uh, Uh, Uh, Uu, Ur, Ww, Uh, Uu, Uu, Uh, Uu, Qxu, Xu, Xu, Xu, Xu, Xu, Xu, Xu, Xu, Xu, Xu, Xu, Xu, Xu, Xu, Xu, Xu, Xu, Xu, Xu
Wwr, Uu, Uh, Uh, Uu, Uu, Uh, Uu^Vud, Uh, Ur, Ww, Qxu, Xu, Xu, Xu, Xu, Xu, Xu, Xu, Xu, Xu, Xu, Xu, Xu, Xu, Xu, Xu, Xu, Xu, Xu, Xu
Uh, Uu, Ur, Ur, Xu, Ur, Wwr, Ur, Uu, Ur, Qxu, Qxu, Xu, Xu, Xu, Xu, Xu, Xu, Xu, Xu, Xu, Xu, Xu, Xu, Xu, Xu, Xu, Xu, Xu, Xu, Xu
Xu, Uh, Uu^Vud, Wwr, Xu, Uh, Uh, Uu, Ur, Ur, Uu, Uu, Uh, Uu^Vud, Ww, Xu, Wo, Ww, Xu, Xu, Xu, Xu, Xu, Xu, Xu, Xu, Xu, Xu, Xu, Xu, Xu
Xu, Xu, Xu, Xu, Ww, Uh, Uu, Ur, Uh, Uh, Uh, Ur, Ur, Uu, Uu, Wwr, Qxu, Uu, Uu, Xu, Xu, Xu, Xu, Xu, Xu, Xu, Xu, Xu, Xu, Xu, Xu
Xu, Xu, Xu, Xu, Xu, Uh, Uu, Uu, Uh, Uh, Xu, Uu, Uu^Vud, Ww, Xu, Qxu, Ww, Qxu, Uu, Ww, Xu, Xu, Ww, Xu, Uu, Xu, Xu, Xu, Xu, Xu, Xu
Xu, Xu, Xu, Xu, Xu, Uh, Ur, Uu, Uh, Xu, Xu, Xu, Xu, Xu, Xu, Xu, Ur, Ur, Xu, Xu, Xu, Xu, Ur, Ur, Ur, Xu, Xu, Xu, Xu, Xu, Xu
Xu, Xu, Xu, Xu, Cud, Cud, Ur, Uu, Uh, Xu, Qxu, Xu, Xu, Xu, Xu, Xu, Uu, Xu, Xu, Uu, Ww, Uu, Qxu, Wo, Xu, Xu, Xu, Xu, Xu, Xu, Xu
Xu, Xu, Xu, Xu, Kud, Uh, Uh, Uu, Uh, Uh, Uu^Vud, Qxu, Xu, Xu, Xu, Ww, Ww, Xu, Ur, Wo, Xu, Qxu, Wo, Ww, Uu, Uu, Wo, Xu, Xu, Xu, Xu
Xu, Xu, Xu, Ww, Cud, Uh, Uu, Uu, Uu, Ww, Qxu, Qxu, Xu, Xu, Ww, Uu, Uu, Ur, Uh, Ur, Xu, Xu, Ww, Xu, Ur, Xu, Xu, Xu, Xu, Xu, Xu
Xu, Xu, Xu, Xu, Qxu, Cud, Uu, Uu, Uh, Uu, Uh, Xu, Ur, Uu, Uh, Uu, Qxu, Qxu, Qxu, Xu, Xu, Xu, Xu, Xu, Ww, Ur, Xu, Xu, Xu, Xu, Xu
Xu, Xu, Xu, Xu, Xu, Qxu, Qxu, Uu, Uu, Uu, Uu, Ur, Wwr, Uu, Xu, Uu, Uu, Ww, Ww, Qxu, Qxu, Xu, Xu, Uu, Wo, Ww, Xu, Xu, Xu, Xu, Xu
Xu, Xu, Xu, Xu, Xu, Xu, Qxu, Uh, Ur, Ww, Uu, Uh, Xu, Xu, Xu, Xu, Xu, Xu, Xu, Ww, Xu, Xu, Qxu, Wwr, Wo, Uh, Ww, Xu, Xu, Xu, Wo
Xu, Xu, Xu, Xu, Xu, Xu, Ww, Uh, Uh, Ur, Xu, Xu, Xu, Xu, Xu, Xu, Xu, Xu, Xu, Wo, Wo, Wo, Ww, Qxu, Qxu, Ur, Ww^Vm, Ur, Ww, Xu, Wo
Xu, Xu, Uu, Uu, Ww, Uu, Uh, Uu, Uu, Ur, Xu, Xu, Xu, Xu, Xu, Xu, Xu, Xu, Xu, Xu, Xu, Xu, Xu, Ww, Ur, Ur, Xu, Ww, Chw, Chw, Chw
Wo, Ww, Uh, Ur, Uh, Uh, Xu, Uu, Ur, Uu, Xu, Xu, Xu, Xu, Xu, Xu, Xu, Xu, Xu, Xu, Xu, Xu, Xu, Xu, Xu, Xu, Ww^Vm, Ur, Chw, 3 Khw, Wo
Wo, Wwr, Xu, Xu, Xu, Xu, Wwr, Ur, Uu^Vu, Uu, Xu, Xu, Xu, Xu, Xu, Xu, Xu, Xu, Xu, Xu, Xu, Xu, Xu, Xu, Xu, Xu, Uh, Ww, Chw, Ww, Wo
Xu, Xu, Xu, Xu, Xu, Uu, Ur, Ur, Uh, Ur, Xu, Xu, Xu, Xu, Xu, Xu, Xu, Xu, Xu, Xu, Xu, Xu, Xu, Xu, Xu, Ww, Xu, Uu, Xu, Wo, Wo
Xu, Xu, Xu, Xu, Xu, Uu, Uu, Ur, Uh, Xu, Xu, Xu, Xu, Xu, Xu, Xu, Xu, Xu, Xu, Xu, Xu, Xu, Xu, Xu, Xu, Wo, Xu, Xu, Xu, Xu, Xu
Xu, Xu, Xu, Xu, Xu, Cud, Cud, Cud, Xu, Xu, Xu, Xu, Xu, Xu, Xu, Xu, Xu, Xu, Xu, Xu, Xu, Xu, Xu, Xu, Xu, Xu, Xu, Xu, Xu, Xu, Xu
Xu, Xu, Xu, Xu, Cud, Cud, Cud, Xu, Xu, Xu, Xu, Xu, Xu, Xu, Xu, Xu, Xu, Xu, Xu, Xu, Xu, Xu, Xu, Xu, Xu, Xu, Xu, Xu, Xu, Xu, Xu
Xu, Xu, Xu, Xu, Ww, 1 Kud, Ww, Xu, Xu, Xu, Xu, Xu, Xu, Xu, Xu, Xu, Xu, Xu, Xu, Xu, Xu, Xu, Xu, Xu, Xu, Xu, Xu, Xu, Xu, Xu, Xu
Xu, Xu, Ww, Ww, Ww, Ww, Xu, Xu, Xu, Xu, Xu, Xu, Xu, Xu, Xu, Xu, Xu, Xu, Xu, Xu, Xu, Xu, Xu, Xu, Xu, Xu, Xu, Xu, Xu, Xu, Xu
