Hh, Hh, Hhd^Fdw, Hhd, Mm, Mm, Mm, Hh, Hh^Fmw, Hh, Mm, Hh, Hh^Fdw, Hh, Mm, Hh, Hh, Mm, Mm, Hh, Hh^Fdw, Hh^Fdw, Hh, Hh, Gg, Gg, Hh, Hh, Mm, Hh, Hh, Mm, Mm, Hh, Hh, Hh, Mm^Xm, Hh
Hh, Hhd^Fdw, Mm, Mm, Mm, Mm, Mm, Mm, Mm, Mm, Mm, Mm, Mm, Mm, Mm, Mm, Mm, Mm, Mm, Mm, Hh^Fmw, Hh, Gg^Efm, Gd^Es, Mm, Mm, Mm, Mm, Mm, Mm, Mm, Hh^Fdw, Hh^Fmw, Mm, Mm, Mm, Mm, Mm
Aa, Hhd^Fmw, Aa, Mm, Aa, Aa, Gs^Fmw, Mm, Mm, Mm, Mm, Mm, Mm, Mm, Hhd, Mm, Mm, Mm, Hh^Fdw, Mm, Gs^Fmw, Gs^Fmw, Gg, Gd^Vo, Hh^Fmw, Mm, Mm, Mm, Mm, Mm, Mm, Mm, Mm, Mm, Mm, Mm, Mm, Hh
Aa, Aa, Hhd^Fmw, Aa, Hh, Hh^Fmw, Gs, Gs^Fmw, Aa, Mm, Hh^Vhh, Hh^Em, Mm, Mm, Mm, Hhd^Fmw, Mm, Mm^Xm, Mm, Hh, Gd^Es, Gd^Es, Gg, Gg^Efm, Hh, Hh, Hh, Mm, Mm, Hh^Em, Hh^Emf, Hh^Fmw, Hh, Mm, Mm, Mm, Mm, Hh
Hh, Hh^Fdw, Hhd^Fmw, Gs^Fdw, Gs, Hh^Fdw, Hh, Hh^Fdw, Gd, Aa, Gg^Efm, Aa, Aa, Mm, Mm, Mm, Mm, Mm, Aa, Gs, Co, Co, Co, Gs, Gd^Es, Gg^Efm, Aa, Mm, Mm, Mm, Mm, Hh^Em, Mm, Hh^Vhh, Hh, Mm, Hhd, Hh
Ww^Wkf, Wwr, Wwr, Hhd, Aa, Aa, Aa, Hh, Gs^Fmw, Hh^Fmw, Hh^Fmw, Hhd, Hhd^Em, Aa, Aa, Mm, Gs^Fmw, Aa, Aa, Aa, Co, 3 Ko, Co, Gs, Hh^Fdw, Hh^Fmw, Hh^Em, Aa, Hh^Emf, Mm, Mm, Mm, Aa, Mm, Mm, Hhd^Fdw, Hhd, Hh
Gll, Ww^Wkf, Ww^Ewl, Hh, Hh, Hh, Aa, Gs^Fdw, Hh, Gs^Fmw, Hh^Fdw, Aa, Hhd^Em, Hh^Emf, Aa, Aa, Gg^Efm, Aa, Hh^Fdw, Hh^Fdw, Co, Co, Co, Hh, Ww^Ewl, Ww^Ewl, Hh, Aa, Hh^Em, Hh^Em, Aa, Aa, Hhd, Aa, Hh, Hh^Em, Hh^Fmw, Hh
Hh, Gll, Gll, Ww^Wkf, Ww^Wkf, Hh^Fdw, Ww^Ewl, Hh^Fdw, Gg^Es, Gs^Es, Hh^Em, Aa, Gs, Gd^Es, Gd^Es, Aa, Gd^Vo, Gg^Efm, Aa, Hh, Hh, Ko, Hh^Fdw, Ww, Wwr, Ww^Wkf, Ww^Wkf, Aa, Aa, Aa, Hh, Hh^Fdw, Hhd^Fmw, Aa, Aa, Hh^Em, Aa, Hh^Fmw
Hh, Gg, Gs, Wwf, Wwf, Ww^Ewf, Ww^Ewf, Hh^Fdw, Hh, Gll, Ww^Ewl, Hh^Emf, Hh^Em, Hh^Fdw, Hh^Fdw, Gs, Aa, Aa, Hh^Fdw, Ww, Ww, Hh, Wwf, Wwr, Wwr, Ww^Wkf, Hh, Hh, Wwr, Ww, Hh, Hh^Fmw, Gll^Es, Hhd, Hh, Aa, Hh^Em, Aa
Hh^Fdw, Hh, Gd^Efm, Gg, Wwf, Ww, Wwr, Ww, Ww, Ww^Ewl, Hh, Ww, Ww, Hh, Ww^Wkf, Ww^Wkf, Ww^Ewl, Aa, Hh^Fdw, Hhd, Ww, Wwf, Hh, Aa, Aa, Ww, Ww^Ewl, Wwr, Ww, Ww, Ww, Ww^Wkf, Ww^Ewl, Gll, Ww, Hh, Hh, Hh^Em
Hhd, Hh^Fmw, Gd^Es, Gg^Efm, Ww, Ww^Wkf, Wwr, Hh, Hh^Fmw, Gs^Fmw, Gs^Fmw, Wwr, Wwr, Ww, Hhd, Hh, Gll, Ww^Ewl, Ww, Hh, Ww^Ewl, Ww^Ewl, Hh, Aa, Gd^Vo, Gd, Wwr, Ww, Aa, Hh, Hh, Ww^Ewl, Hh, Ww, Wwr, Ww^Wkf, Ww^Wkf, Ww^Wkf
Hhd, Hh^Fmw, Hh, Gs, Gs^Fmw, Gg^Es, Gs, Gg, Gg^Efm, Gg, Gg, Wwr, Hh, Hhd, Hh, Hh, Gll, Wwr, Ww, Wwf, Ww^Wkf, Ww, Hh, Gg, Aa, Gs, Gs, Ww, Aa, Gd, Hhd, Hh, Hh, Gll, Ww, Wwr, Ww^Ewf, Ww^Ewl
Mm, Mm, Mm, Gs^Fdw, Hh^Fmw, Hh, Hhd^Em, Gs^Fp, Gg, Gd^Vo, Gg, Hh, Gg, Gg, Gs, Gg, Gg^Efm, Gll, Gll, Ww^Wkf, Gs, Hh, Gg, Aa, Gs, Aa, Aa, Aa, Gd, Hhd, Mm, Hhd, Gs, Gll^Es, Gll, Ww, Ww^Wkf, Ww^Ewl
Hh^Em, Mm, Mm, Mm, Mm, Hh, Hhd^Em, Gs^Fp, Gs, Gg^Efm, Gg^Efm, Gs, Gd^Es, Gs^Es, Gs^Fmw, Gg, Gg, Gg, Gg, Ww^Wkf, Gd, Gg, Hhd^Em, Gg, Gg, Gd, Gs, Gd, Gg, Mm, Mm, Mm, Mm, Gs, Gg, Ww, Gll, Gll
Hhd^Em, Hhd^Emf, Aa, Mm, Mm^Xm, Hhd, Aa, Aa, Gd, Gg^Efm, Gg, Aa, Gs, Gd^Es, Hh^Fmw, Hh, Mm, Hh^Em, Hh, Gs, Hhd^Em, Hhd^Emf, Mm, Mm, Mm, Gg, Gs, Gg, Hh, Hh, Hh^Fmw, Mm, Mm, Mm, Hhd^Fmw, Hh, Hh, Hh
Aa, Hhd^Em, Aa, Mm, Mm, Mm, Aa, Gd^Es, Gd^Vo, Gg, Aa, Aa, Mm, Mm, Mm, Mm, Mm, Mm, Mm, Hh^Fmw, Mm, Mm, Mm, Mm, Hh, Gg, Gg, Gg^Efm, Aa, Gg, Gs, Hh^Fdw, Hhd^Em, Hhd, Hhd, Hh, Gg, Gg
Hh^Fdw, Aa, Hh, Hhd, Hh^Fmw, Hh^Fmw, Hh^Fdw, Gs, Gg, Gg, Aa, Aa, Aa, Mm, Mm, Mm, Mm, Mm, Mm, Mm, Mm, Mm, Hhd^Fmw, Hhd^Fmw, Hh^Fmw, Gd^Efm, Gg, Aa, Gg, Aa, Aa, Gs^Fmw, Hh, Mm, Mm, Hhd, Gg, Gg
Hh^Fdw, Hh, Aa, Hh^Fdw, Aa, Aa, Aa, Hh, Gg^Efm, Gs^Fp, Gs^Fp, Gd, Gs^Fdw, Hh, Hhd^Em, Mm, Mm, Hhd^Em, Mm, Mm, Mm, Mm, Mm, Hhd^Fdw, Hh, Gs^Fdw, Gs, Gg, Aa, Gg^Efm, Gs^Es, Gd, Hh, Gs, Aa, Mm, Gg, Gg
Hh, Aa, Hh, Gs^Fdw, Gg, Hhd, Gg, Gg^Efm, Gll^Es, Gg, Gg^Efm, Aa, Aa, Hh^Fmw, Mm, Mm, Mm, Mm, Mm, Mm, Mm, Mm, Mm, Mm, Hh, Hh, Gg, Gg, Aa, Aa, Aa, Gd, Gg, Aa, Gs, Gs, Gg, Gg
Aa, Aa, Gd, Gs, Ww, Gg, Gll, Gll, Ww, Gll, Gs, Aa, Gs, Gs^Fdw, Hh, Hhd, Hhd^Em, Mm, Mm, Mm, Mm, Mm, Mm, Mm, Hh, Gg, Gs^Fmw, Gg^Efm, Gg, Gs, Aa, Aa, Gg, Aa, Gd, Gs^Fmw, Gg, Gg
Wwr, Wwr, Ww^Ewl, Ww, Wwf, Ww^Wkf, Ww^Wkf, Ww, Hh, Ww^Wkf, Ww^Ewl, Gs, Gs, Gg, Hh, Hh^Fdw, Mm, Mm, Mm, Mm, Hhd^Em, Hhd^Emf, Hhd^Em, Hhd^Vhhr, Gg, Gg^Efm, Gg, Gg^Efm, Gg^Efm, Gd^Vo, Gd^Es, Aa, Gg, Gd, Hhd, Gg, Hh, Gg
Ww^Wkf, Ww, Ww, Ww^Ewf, Wwf, Ww^Wkf, Hh, Hh, Hhd, Hh, Ww^Ewl, Ww^Ewf, Ww^Ewf, Gll, Gg, Hh^Fmw, Hh^Fmw, Mm, Mm, Mm, Mm, Hh^Em, Gs, Gs, Wwr, Gg, Gll, Gg, Gg, Gg, Gg, Gg^Es, Gg^Efm, Gg, Hh, Hh, Gs, Gg
Hh^Fdw, Hh^Fdw, Hh, Ww, Ww, Ww^Wkf, Hhd, Hhd, Hh^Fmw, Hh^Fdw, Hh, Hh, Ww, Gll^Es, Gll^Es, Gs^Fmw, Gs^Fdw, Hh, Gg^Efm, Mm, Hh, Gg, Ww^Wkf, Ww, Ww, Wwr, Gll^Es, Gg^Es, Hh, Gg, Gs^Wm, Gg, Hh, Hh^Fdw, Mm, Mm^Xm, Mm, Gs
Hhd, Hh^Fmw, Hh^Em, Hhd^Em, Hh^Fdw, Hh^Fmw, Hh, Gs^Fdw, Gs^Fmw, Hh^Fmw, Hhd, Ww, Wwf, Ww, Ww^Wkf, Gg, Gg, Gg^Efm, Gll, Hh, Gll, Gg, Ww^Wkf, Hh, Ww^Ewl, Ww, Ww, Gll^Es, Hh, Gs, Gs, Gg, Hh, Hh^Fmw, Hhd^Emf, Mm, Hhd, Gd
Hhd, Hh, Hhd^Em, Hhd^Emf, Hh^Em, Hh^Fdw, Gd, Hh, Gs^Fdw, Gll, Hhd^Em, Ww^Wkf, Ww, Wwf, Ww^Wkf, Ww, Ww^Ewl, Wwr, Wwr, Gll, Ww^Ewl, Ww, Hh^Fdw, Hh, Ww^Ewl, Hh, Ww^Wkf, Gll, Hh, Hh, Gs, Gg, Gs, Hh^Em, Gs, Hhd^Em, Gg, Gs
Gll^Fdw, Hh, Gg, Hh^Em, Gs, Gd, Hh^Fmw, Gs, Gg, Hh, Hh^Emf, Hhd^Em, Hh^Fdw, Ww^Wkf, Wwr, Hh^Fdw, Hh^Fmw, Ww, Ww, Ww^Ewl, Ww^Wkf, Hh^Fdw, Hh^Fmw, Hhd, Hh, Hh, Ww^Wkf, Ww, Ww, Ww^Ewl, Gll, Gll, Gll, Gll, Ww^Wkf, Hhd^Em, Gll, Gg
Hh, Gll, Hhd, Gg^Efm, Gg, Hh, Hh, Hh, Gs, Gs, Hh, Hh^Fdw, Gg, Gll, Hh, Hh^Fmw, Hhd, Hh, Hh, Hh, Hh, Hh, Hh, Hh^Fmw, Hhd^Em, Hhd^Em, Hh^Em, Hh^Fdw, Ww^Ewf, Ww, Wwr, Ww, Ww, Ww, Ww, Gll, Ww^Ewl, Gll
Mm, Hh, Hh, Hh, Gs^Fmw, Gs, Gs, Gg, Gg, Gs, Gg, Gg, Gs, Gg, Hhd, Hh^Fdw, Hhd, Hh, Hh^Fmw, Hhd, Hhd, Gll, Gll, Hhd, Hh^Em, Hhd^Emf, Hhd^Em, Ww^Ewl, Hh, Ww^Ewl, Ww, Ww, Wwf, Wwf, Wwf, Ww, Ww, Ww^Ewl
Hhd, Mm, Mm, Hh, Hhd^Vhhr, Gd, Chr, Chr, Chr, Gg^Efm, Gd^Vhr, Gg^Es, Gs^Fdw, Hh^Fmw, Hh, Hh, Hh, Hh^Fmw, Gs^Fdw, Hh^Fdw, Gg^Efm, Gg, Hh, Gd, Gs, Hh^Em, Hh, Hh, Hh^Fmw, Hhd, Ww^Wkf, Ww^Wkf, Chw, Chw, Chw, Wwf, Gll^Fmw, Ww
Hhd, Hhd, Hh, Hh^Fdw, Hhd, Gs, Chr, 2 Khr, Chr, Gg, Gg, Gd^Es, Gd, Hh^Fdw, Gs, Gs, Gg^Efm, Hh, Gd, Gs, Gd^Vo, Gg, Hh, Gd^Es, Gs, Hh, Hhd, Hhd, Hhd, Hh^Fdw, Hhd, Ww^Wkf, Chw, 1 Khw, Chw, Gll, Hh^Fmw, Gll^Fdw
Mm, Mm, Mm, Mm, Mm, Gg, Gs, Chr, Gs, Gg, Gs^Fmw, Gg^Es, Gs, Hh, Gg, Hh, Gg^Efm, Gs, Mm, Mm^Xm, Mm, Gs, Gg, Gg, Hhd^Em, Gg^Efm, Gg, Hhd, Hh^Fdw, Hhd^Vhhr, Hh, Hh, Gg, Chw, Gg, Gd, Mm, Hh
Mm, Mm, Mm, Mm, Mm, Mm, Hh, Gd, Hh, Gg, Hh^Fmw, Hh^Fdw, Hh^Fdw, Hh, Gg, Gg^Efm, Mm, Mm, Mm, Mm, Mm, Mm, Mm, Hhd^Emf, Hhd^Em, Gg^Efm, Hh^Fmw, Gs, Gg^Efm, Hh^Fdw, Gs, Hh, Gd^Vhr, Gs^Efm, Mm, Mm, Hh^Fmw, Hh^Fmw
Mm, Mm, Mm, Mm, Mm^Xm, Hh^Fdw, Mm, Hh, Mm, Mm, Mm, Mm, Mm, Gg, Gs, Hh, Hh, Mm, Mm, Mm, Mm, Mm, Mm, Mm, Mm, Gg, Gs^Fdw, Hh^Fmw, Hh, Gs, Hh, Gd^Es, Mm, Mm^Xm, Mm, Hh^Fdw, Mm, Hh^Fmw
Hh, Mm, Mm, Mm, Mm, Mm, Hh, Mm, Mm, Mm, Mm, Mm, Hh, Mm, Hh, Gd, Gs, Hh, Hh, Mm, Hh, Hh, Hh, Mm, Hh, Hh, Gs^Fdw, Hh, Gg, Gs, Gg, Gg, Hhd, Mm, Mm, Mm, Hh, Hh
