Ms, Ms, Ms, Ms, Ms, Ms, Ms, Ms, Ha^Esa, Ha, Hhd, Gs, Gg, Gg^Efm, Gs, Gs, Gs, Gs, Gd, Gg, Gg, Gg, Gs, Gs, Gs, Gs^Efm, Gs^Efm, Gs, Gs, Gs, Gs, Gs, Gs, Gs, Gs, Gs, Gd, Gd
Ms, Ms, Ms, Ms, Ms, Ms, Ms, Ha^Esa, Ha, Ha, Hhd, Hhd, Hhd, Gs, Gd, Gs^Vc, Aa, Gd, Aa, Gd, Re, Gs, Gg, Aa, Gg, Gs, Gs, Gs, Gd, Gd, Gd^Esa, Aa, Aa, Aa, Gd^Es, Gs^Efm, Aa, Gd
Ms, Ms, Ms, Ms, Ms, Ms, Ha, Ha, Ha^Esa, Ha^Esa, Hh, Hhd, Hhd^Fmw, Hh^Fmw, Gd, Aa^Esa, Aa, Aa, Aa, Aa^Esa, Aa^Esa, Re^Esa, Re, Gg, Gll, Gd, Gs, Gs^Edt, Aa, Aa^Esa, Aa^Voa, Aa, Gd, Gd^Es, Gs, Gs, Gs, Gs
Ms, Ms, Ms, Aa, Aa, Aa, Ha, Ha^Voa, Ha^Esa, Hh, Hhd, Hhd, Hhd, Hh, Gs, Gd, Gs^Edt, Gs^Edt, Gs^Edt, Re, Re, Aa, Re, Gs, Gll, Re, Re^Es, Aa, Re^Es, Aa, Gd, Aa, Gd, Gs, Gs, Gd, Gd, Gs
Ms, Ms, Ms, Ms, Aa, Aa, Hh, Ha, Hh, Hh, Hhd, Hh, Hh^Em, Hhd, Gd, Gs, Gg, Gs^Vo, Gs, Gd, Gll^Es, Re, Gg, Gg, Gs^Efm, Gll, Gs, Re^Es, Gd, Re, Gs, Gd, Hh, Hh, Gs, Gs^Efm, Gll, Gd
Ms, Ms, Ms, Ms, Hh, Hh, Hh, Hh, Hh, Hhd, Hh, Hhd^Em, Gg, Gd, Gs, Hh, Hh, Gg, Gg^Efm, Gd, Gll^Es, Gg, Hh, Gg, Gg, Gs^Efm, Gg^Efm, Gg^Efm, Gd, Gs, Gg, Hh, Hh, Hh, Gd^Edt, Gs^Edt, Gll^Es, Gd
Ms, Ms, Ms, Aa, Hh^Vo, Hhd, Hhd, Hh^Fmw, Hh, Hh, Hh, Gg, Gs, Gs, Hh, Mm, Gd, Gs, Gs, Gd, Hhd, Gd, Gd, Hh, Gg, Gs, Gs, Aa^Esa, Gd, Gs, Hhd, Gg, Gg, Hh, Gd, Gd, Gs, Gll
Ms, Ms, Ms, Hh, Hh, Hh, Hhd^Fmw, Hh^Fmw, Hhd, Hh, Gg, Gg^Efm, Gs, Gs, Gll, Hhd, Gd, Gs, Hhd^Vo, Hh, Hhd^Em, Hhd^Em, Co^Edt, Hh^Em, Hh^Em, Gg, Hh, Gs, Gs^Edt, Gs, Gs, Gg, Gs^Fmw, Gd, Gd, Gs, Gs^Vo, Gs
Ms, Ms, Ms, Hhd^Emf, Hh^Em, Hh^Fmw, Hhd^Fmw, Hhd, Hhd, Hh, Gs, Gs^Vo, Gg^Efm, Gs^Efm, Gll, Gd^Efm, Gd, Hhd, Hh^Em, Hhd, Co^Edt, Co^Edt, 3 Ko, Co^Edt, Mm, Hh, Re, Hh, Hh, Gs^Edt, Gg, Gg, Gll^Fmw, Gs^Fmw, Gs, Gs, Gs, Gs^Efm
Ms, Ms, Ms, Hhd^Em, Hhd, Hhd, Hh, Hhd, Hhd, Hh, Gs, Gg^Efm, Re, Gs, Gs, Gll, Gll^Es, Hh, Hh^Em, Rb, Co, Co^Edt, Hh^Emf, Co, Co, Hh, Rb^Es, Re^Es, Hh, Gg^Edt, Gs, Gs, Gs, Gs, Gs, Gll^Edt, Gll, Gs^Efm
Ms, Ms, Ms, Hh, Hh, Hh, Hh, Hhd, Hhd, Hh, Gd, Gd, Gd^Es, Re^Es, Gs, Gs, Gll^Es, Gs, Hh, Hh^Em, Hh, Ko, Hh^Em, Hh^Em, Wwr, Hhd, Hhd, Hhd, Hhd, Gs, Gll, Gll, Gg, Gg^Vo, Gg^Edt, Gll^Edt, Gll, Gs
Ms, Ms, Ms, Ms, Hhd, Hh^Vo, Hh, Hh, Gg^Es, Gg, Gg, Gg, Gs, Re^Es, Gll, Gll^Es, Wwf, Wwf, Ww, Hh, Ww^Ewl, Wwr, Wwr, Ww, Ww, Wwf, Wwr, Hhd, Ww, Ds, Wwr, Wwr, Wwr, Wwr, Ww, Gs, Gll, Gll
Ms, Ms, Ms, Ms, Hh, Hhd^Em, Hh, Hhd, Hhd, Gs, Gll^Es, Gs^Efm, Gll, Ds, Wwr, Ww^Wkf, Ww, Ww, Ww^Ewl, Ww^Ewl, Ww^Wkf, Ww^Ewl, Gll, Ww, Gg, Wwf, Wwf, Wwr, Ww, Ww, Ww^Wkf, Ww^Ewl, Ds, Ww, Ww^Wkf, Ww, Wwr, Wwr
Ms, Ms, Ms, Ms, Aa, Hhd^Em, Hh^Em, Hh, Hhd, Hhd, Hhd, Gll, Gd, Ww, Ww^Wkf, Ww^Wkf, Ds, Ds, Gs^Edt, Gd^Edt, Gd, Gll, Gs, Gs, Gg^Es, Gs^Es, Ds, Ds, Gg^Edt, Ww^Wkf, Ds, Ds, Gg, Gll^Edt, Gg^Edt, Ds, Gg, Ww
Wo, Ms, Ms, Ms, Ai, Aa, Ai, Hh, Wwr, Hhd, Wwr, Hhd, Ww, Wwr, Ww, Ds, Rd, Gs^Edt, Gd^Vc, Gd, Gd^Es, Gs^Edt, Gs^Vo, Gs, Gg, Gs, Gs^Es, Gs^Es, Gs, Gg, Gg, Gg, Gs, Gs, Gs, Gg, Gs, Gll
Ms, Wo, Wo, Wo, Wo, Ai, Wo, Wwr, Ww^Ewl, Wwr, Ww, Ww^Wkf, Wwf, Ww, Gs, Ds, Rd, Gs^Edt, Gs, Gs, Gd, Gs, Gs^Edt, Gs, Gg, Re, Re, Gd^Es, Gd, Gs, Gs, Gd, Gd, Gd^Em, Gs, Gs^Edt, Gs^Efm, Gs
Ms, Ms, Ms, Ha, Ha, Wo, Ha, Ww, Hh, Ww, Hh, Hh, Gll, Gg, Gs, Ds, Rd, Gs, Gll, Gd, Aa^Fma, Aa, Aa, Gs^Edt, Gs^Edt, Gg^Efm, Gg^Efm, Re^Es, Re^Es, Gll, Gs^Efm, Gs^Efm, Gs^Em, Gd^Vo, Gs, Gs, Gs, Gs^Efm
Ms, Ms, Ha, Aa, Aa, Ha, Aa, Hh, Hh^Vc, Hh, Hh, Hh, Gg, Gg, Gs^Efm, Gs^Edt, Gs^Edt, Gll, Gd, Gd, Ha^Fma, Ha^Fma, Ha^Fma, Aa^Fma, Aa^Edt, Gs^Edt, Gs, Gg^Efm, Re^Es, Gs, Gs, Gs, Gs, Gs, Gll^Fmw, Gll^Fmw, Gs, Gs^Efm
Ms, Ms, Aa, Aa, Gs, Aa, Gs, Hh, Hh, Hh, Hhd, Hh, Gg^Efm, Gs^Efm, Gd, Gs^Edt, Gll^Es, Gll, Gd, Ha^Voa, Ha^Fma, Hh^Fmw, Hh^Fmw, Ha^Fma, Gs^Fmw, Gs^Edt, Gd, Gd^Efm, Re, Gs, Gll, Gll, Gg, Gll^Fmw, Ai, Gll^Fmw, Gd, Gd
Mm, Ms, Mm, Gs^Edt, Hhd, Hhd, Hh, Hh, Hh, Hh, Hh, Hh, Gg^Efm, Gs, Gd, Gd^Es, Gd, Gd, Aa, Ha, Gd^Em, Hh^Fmw, Hhd^Fmw, Hh^Fmw, Hh, Gs^Edt, Gs, Gd, Gd, Re, Gs^Edt, Gll, Gg, Ai, Ai, Ai, Ai, Gd
Mm, Mm, Mm, Gd^Edt, Gd^Edt, Hhd, Hhd, Hh^Fmw, Hh^Vo, Hh, Hh, Hh, Gg, Gd, Gd, Re^Es, Re^Es, Gg, Gg, Aa, Gd^Em, Hh^Emf, Gd^Em, Hhd^Em, Gll^Edt, Gs, Gd, Gs^Wm, Gd, Re, Gd^Edt, Gll, Gg, Ai, Ai, Ai, Ai, Ai
Mm, Mm, Ms, Mm^Vc, Hhd, Hhd, Hhd, Hh^Fmw, Hhd^Fmw, Hh, Hh, Hh, Gg, Gs, Gs, Gs, Gs, Re^Es, Re^Efm, Gg, Gs, Gd^Em, Gll, Gll^Edt, Rd, Gll, Gd, Gs, Gs, Re^Edt, Gd, Gs, Gg, Ww, Wwf, Ai, Wwf, Ww
Ms, Ms, Aa, Aa, Gs, Hh^Edt, Hhd, Hh, Hh, Hhd, Hh, Gg, Gs^Efm, Gs^Es, Gs, Gs^Fp, Gs^Fp, Gg, Gg^Efm, Gg^Efm, Gs, Gll, Gs, Rd^Edt, Rd, Gll, Gs, Gs, Gd, Rd, Gs, Gs, Gs^Efm, Gg, Gg, Wwf, Gg, Gg
Ai, Ms, Ww, Aa, Gg, Hh, Hhd, Hh, Hh, Hh, Hh, Gg, Wwr, Gs, Gd, Gs, Gll^Fp, Gll, Gd, Gd, Gs, Gs, Gs, Gs, Gs^Em, Gs, Gs, Gs^Efm, Gs^Es, Rd^Es, Gs, Gs^Efm, Gs, Gs, Gll, Gg, Gd, Gs
Ai, Ai, Ww^Wkf, Ww, Ww, Ww, Ww, Wwf, Wwr, Ww, Ww, Ww, Wwr, Wwf, Wwr, Gd, Gd, Gs, Gd^Em, Gs^Em, Gg, Gs^Vc, Hh, Hh^Em, Hh^Emf, Ha^Em, Ha^Em, Gll, Gs, Rd, Rd, Gs, Aa, Gll, Gll, Gll, Gll, Gd
Ms, Ms, Ms, Wwr, Hhd^Esa, Ai^Esa, Wwr, Wwr, Hh, Ww, Gg^Efm, Wwr, Wwf, Wwf, Ww, Ds, Ds, Gd, Gg^Em, Rd, Rd, Gg, Gll, Gg^Es, Gll^Es, Hh^Em, Ha, Ha, Aa^Voa, Aa, Aa, Aa, Aa, Gs, Gs, Gs, Gs^Edt, Gd
Ms, Ms, Ms, Ha, Hhd^Esa, Hhd^Esa, Hh, Hh, Hh^Esa, Hhd, Gd, Gd, Gd^Edb, Gll, Gg^Es, Ww, Ww^Wkf, Ds, Gg, Gs^Em, Gs, Gll, Gs, Gll, Gs^Efm, Gll, Gll, Aa, Gs, Aa, Gd, Rd, Gd, Aa, Gs^Em, Gd^Edt, Gs^Edt, Gs
Ms, Ms, Ms, Hhd, Hh, Hh, Hh, Hh^Vo, Hh, Hhd, Hhd, Gs, Gll^Edb, Gd^Edb, Gd, Gll^Es, Ww, Ww^Ewl, Gll, Gs, Gs^Edt, Gs, Gll, Gs^Efm, Gg^Efm, Gs, Gs, Gll, Gs, Gs, Gd^Edt, Rd, Rd^Es, Gs, Gd, Gs, Gd^Edt, Gd
Ms, Ms, Ms, Hhd, Hhd, Hhd, Hh, Hh, Hhd, Hh, Hh, Hhd, Hhd, Gll^Edb, Gd, Gll^Es, Gll, Ai, Ai, Gll^Edt, Gll, Gg, Gg, Gg, Gg, Gs, Ds, Gs, Gs^Edt, Gs^Edt, Gs^Edt, Gs, Gd, Rd^Es, Re^Es, Gd^Em, Re, Re
Ms, Ms, Ha, Hhd^Esa, Hh, Hhd, Hh, Hh^Esa, Hhd^Esa, Hh, Hhd, Hh, Hhd, Gll, Re, Gg^Efm, Gd, Gll, Gll^Es, Ai, Wwr, Gs, Wwr, Ds, Wwf, Ds, Ds, Ds, Ds, Ds, Gd^Edt, Gd, Ds, Gd, Gd, Re, Gd, Gd
Ms, Ms, Ha, Ha^Esa, Ha^Esa, Ha^Esa, Hh, Hh^Esa, Hhd, Hhd, Hh^Em, Hh^Em, Hh^Em, Re, Gg^Efm, Gs, Rd, Rd, Gs^Efm, Gll^Es, Gll^Es, Ww, Ww, Wwr, Wwf, Wwr, Wwr, Wwr, Wwr, Ds, Ww, Wwf, Ww, Ww, Wwr, Ds, Wwr, Ww
Ms, Ms, Ha, Ha, Ha, Ha^Esa, Hh, Hhd, Hh, Hh, Hh^Em, Chr, Chr^Edb, Re, Gs^Edb, Gs, Gll, Gs, Gd, Gd, Gd, Ds, Ds, Ww, Gll, Ww, Ww, Ww, Ww, Wwf, Ww^Wkf, Ww^Wkf, Chw, Ww, Chr, Wwr, Ww, Ww^Ewl
Ms, Ms, Hhd^Em, Hh, Hh, Hh^Em, Hh^Esa, Hh, Chr^Edb, Chr, Hhd^Emf, Hhd, Gd^Em, Re^Edb, Gs, Rd, Gs, Re, Aa, Re, Re^Edb, Gs^Edb, Gd, Gll, Gs, Gg, Gs, Wwr, Gll, Gll, Chr^Edb, Chw, 1 Khr, Chr, Gg, Gll, Chw, Ww^Ewl
Ms, Ms, Hhd^Emf, Hhd^Em, Mm, Hh, Chr^Esa, Hh, Chr, Chr^Edb, Chr^Edb, Chr^Edb, Gd^Em, Gll, Gs, Rd^Es, Gs, Re, Re, Aa, Aa^Esa, Gd^Em, Aa^Esa, Gd, Gd, Gs^Efm, Gs, Gs, Gll, Gll^Em, Gd, Chr^Edb, Gd^Edb, Gd^Edb, Gll, Chr, Gs^Efm, Gg
Ms, Ms, Ms, Hhd^Em, Mm, Hh, Hhd^Esa, Hh, Hh, 2 Khr, Hh, Gd^Em, Gll, Gll, Gs^Edb, Rd^Es, Rd^Es, Gs, Gll, Re, Re, Aa^Esa, Aa, Aa, Gd, Gs, Gg^Efm, Gs, Gs, Gs^Edb, Gs, Gd^Edb, Gll, Gd^Ecf, Gll, Gs^Efm, Gll^Edb, Gll^Edb
Ms, Ms, Mm, Mm, Ha, Mm, Ha^Esa, Hhd^Esa, Hh, Hh, Re^Es, Re, Gs, Gs, Gs, Gs^Vo, Rd, Gg^Efm, Gs, Gs, Gll, Gd, Gd^Edb, Gd^Edb, Gs, Gs^Vc, Gs, Gg^Efm, Gg, Re, Gll, Gs^Edb, Re^Esa, Re, Re, Gs, Ha, Ha^Esa
Ms, Ms, Ms, Ms, Ms, Ha, Ha, Ha^Esa, Hh, Hh, Re, Gs, Gd, Gd^Em, Gd, Rd, Gg, Gg, Gs, Gs, Gs, Gll, Gs, Gs, Gs, Gs, Gs, Gg^Efm, Gg, Re, Gd, Gd, Aa, Aa^Esa, Aa, Ha, Ha, Ha
