Ms, Ms, Ms, Ms, Ms, Ms, Ms, Gg, Ha, Gg, Hh, Gs, Gg, Gs, Gs, Gs, Gs, Gs, Gg^Edt, Gg, Gg^Edt, Gg, Gg, Gs, Gs, Gs, Gs, Gg^Efm, Gg^Efm, Gg^Efm, Gg^Efm, Gs, Gs, Gs, Gg, Gg, Gs, Gg
Ms, Ms, Ms, Ms, Ms, Ms, Ms, Ha, Ha, Ha, Hh, Hh, Hhd, Gg, Gs, Gs^Vc, Aa, Gs, Aa, Gs^Edt, Gs^Edt, Gg^Edt, Gg, Gs^Vo, Gs, Gs, Gs, Gg^Efm, Gs, Gg^Efm, Gg^Efm, Aa, Aa, Aa, Gs, Gg, Gs^Vc, Gs
Ms, Ms, Ms, Ms, Ms, Ms, Ha, Ha, Ha, Ha, Hh, Hh, Hhd^Fmw, Hh^Fmw, Gs, Aa, Aa, Aa, Aa, Aa, Aa, Gs, Gs, Gs, Gs, Gd, Gg, Gs, Aa, Aa, Aa^Voa, Aa, Gs, Gs, Gs, Gs, Gs, Gs
Ms, Ms, Ms, Aa, Aa, Aa, Ha, Ha^Voa, Ha, Hh, Hhd, Hh, Hh, Hh, Gs, Gg, Gs, Gs, Gs^Edt, Gs^Edt, Gg^Edt, Aa, Gg, Gs^Edt, Gs, Gd, Gd^Edt, Aa, Gd, Aa, Gd, Aa, Gs, Gs, Gs, Gd, Gd, Gs
Ms, Ms, Ms, Ms, Aa, Aa, Hh, Ha, Hh, Hh, Hh, Hh, Hh, Hhd, Gd, Gs, Gs, Gs^Vo, Gs, Gg, Gs, Gg^Edt, Gs, Gg, Gs, Gs^Edt, Gs, Gd^Edt, Gs, Gd, Gs, Gs, Hh, Hh, Gs, Gg^Efm, Gg^Efm, Gd
Ms, Ms, Ms, Ms, Hh, Hh, Hh, Hh, Hh, Hhd, Hh, Hh, Gg, Gd, Gs, Hh, Hh, Gs, Gs, Gg, Gs^Ecf, Gs, Hh^Fetd, Gs, Gs, Gs, Gg^Efm, Gg^Efm, Gg^Efm, Gs, Gg^Efm, Hh, Hh, Hh, Gs, Gg^Efm, Gg^Efm, Gd
Ms, Ms, Ms, Aa, Hh^Vo, Hhd, Hhd, Hh^Fmw, Hh, Hh, Hh, Gg, Gs, Gs, Hh, Mm, Gd, Gs, Gg, Gs, Hh, Gs, Gs^Edt, Hh^Edt, Gs^Edt, Gs, Gs, Gs^Vo, Gg^Efm, Gs^Es, Gg^Efm, Gg^Efm, Gs, Hh, Gs, Gg^Efm, Gg^Efm, Gg^Efm
Ms, Ms, Ms, Hh, Hh, Hh, Hhd^Fmw, Hh^Fmw, Hh, Hh, Gs, Gg, Gs, Gs, Gs, Hhd, Gd, Gs, Hhd^Vo, Hh, Hh, Hh, Co, Hh, Hh, Gs^Edt, Hh, Gs, Gg^Efm, Gg^Efm, Gs, Gs, Gs^Fmw, Gs, Gs, Gs, Gs^Vo, Gs
Ms, Ms, Ms, Hhd, Hh, Hh^Fmw, Hhd^Fmw, Hh, Hhd, Hh, Gs, Gs^Vo, Gs^Edt, Gs^Edt, Gs^Edt, Gd, Gd, Hhd, Hh, Hh, Co, Co, 3 Ko, Co, Mm, Hh, Gs^Edt, Hh, Hh, Gg^Efm, Gg^Efm, Gs^Efm, Gll^Fmw, Gs^Fmw, Gd, Gs, Gs, Gs
Ms, Ms, Ms, Hhd, Hh, Hh, Hh, Hh, Hh, Hh, Gd, Gs, Rd, Gg^Efm, Gs^Edt, Gs, Gg, Hh^Edt, Hh^Edt, Gg^Ecf, Co, Co, Hh, Co, Co^Edt, Hh^Edt, Gs, Gs, Hh, Gg^Efm, Gg^Efm, Gs, Gs, Gs, Gs, Gs, Gs, Gs
Ms, Ms, Ms, Hh, Hh, Hh, Hh, Hh, Hh, Hh, Gs, Gs, Gg^Efm, Gg^Efm, Gs, Gs, Gs, Gs, Hh, Hh, Hh, Ko, Hh, Hh, Wwr, Hh^Edt, Hh, Gs, Hh, Gg^Efm, Gs, Gs, Gs, Gg^Vo, Gg, Gs, Gs, Gg
Ms, Ms, Ms, Ms, Hhd, Hh^Vo, Hh, Hh, Gs, Gs, Gg^Efm, Gg^Efm, Gg^Efm, Rd, Gg^Efm, Gs, Ww, Ww, Ww, Hh, Ww, Wwr, Wwr, Ww, Ww, Ww, Wwr, Hh, Ww, Gg^Efm, Ww, Ww, Ww, Ww, Ww, Gg, Gg, Gg
Ms, Ms, Ms, Ms, Hh, Hhd, Hh, Hh, Hh, Gg^Efm, Gg^Efm, Gg^Efm, Gg^Efm, Gg^Efm, Wwr, Ww, Ww, Ww, Ww, Ww, Ww, Ww, Gg, Ww, Gg^Es, Ww, Ww, Ww, Ww, Ww, Ww, Ww, Gg^Efm, Ww, Ww, Ww, Wwr, Wwr
Ms, Ms, Ms, Ms, Aa, Hhd, Hh, Hh, Hh, Hh, Hh, Gg^Efm, Gg^Efm, Ww, Ww, Ww, Gs, Gs^Edt, Gs, Gg, Gs, Gg, Gs, Gg, Gg^Es, Gg^Es, Gg, Gg, Gs, Ww, Gg^Efm, Gg^Efm, Gs, Gs, Gs, Gg, Gs, Ww
Wo, Ms, Ms, Ms, Ai, Aa, Ai, Hh, Ww, Hh, Ww, Hh, Ww, Ww, Ww, Gg, Rd, Gs, Gd^Vc, Gs, Gs, Gs, Gs^Vo, Gg, Gg, Gs, Gs, Gs, Gd^Em, Gs, Gs^Es, Gs, Gg, Gg, Gg, Gs, Gs, Gs
Ms, Wo, Wo, Wo, Wo, Ai, Wo, Ww, Ww, Ww, Ww, Ww, Ww, Ww, Gd, Gs, Rd, Gs, Gs^Em, Gs, Gg, Gs, Gs, Gs, Gg, Rd, Rd, Gs^Es, Gd, Gs, Gs, Gg^Efm, Gd, Gd, Gg, Gs, Gd, Gs
Ms, Ms, Ms, Ha, Ha, Wo, Ha, Ww, Hh, Ww, Hh, Hh, Gs, Gd, Gs, Gs^Edt, Rd^Edt, Gs^Edt, Gg, Gg, Aa^Fma, Aa, Aa, Gs, Gg, Gg, Gg^Efm, Rd^Es, Re, Gd, Gd, Gs, Gs, Gd^Vo, Gs, Gs, Gs, Gs
Ms, Ms, Ha, Aa, Aa, Ha, Aa, Hh, Hh^Vc, Hh, Hh, Hh, Gs, Gg, Gs, Gs, Gs, Gs, Gg, Gg, Ha^Fma, Ha^Fma, Ha^Fma, Aa^Fma, Aa^Fma, Gs^Efm, Gs, Gg^Efm, Re, Gd, Gg, Gg, Gg, Gs, Gll^Fmw, Gll^Fmw, Gs, Gs
Ms, Ms, Aa, Aa, Gg, Aa, Gg, Hh, Hh, Hh, Hhd, Hh, Gs, Gs, Gg^Efm, Gg, Gs, Gg, Gg, Ha^Voa, Ha^Fma, Hh^Fmw, Hh^Fmw, Ha^Fma, Gs^Fmw, Gs, Gs, Gg^Efm, Re, Gd, Gd, Gs, Gg, Gll^Fmw, Ai, Gll^Fmw, Gs, Gg
Mm, Ms, Mm, Gg, Hhd, Hh, Hh, Hh, Hh, Hh, Hh^Em, Hh, Gs, Gg, Gg^Efm, Gg^Efm, Gg^Efm, Gg, Aa, Ha, Gs, Hh^Fmw, Hhd^Fmw, Hh^Fmw, Hh, Gs, Gg^Efm, Gs, Gd, Re, Gd, Gs, Gg, Ai, Ai, Ai, Ai, Gs
Mm, Mm, Mm, Gd, Gd, Hh, Hhd, Hh^Fmw, Hh^Vo, Hh, Hh, Hh, Gs, Gg, Gs, Rd, Rd, Gs, Gs, Aa, Gs, Hh, Gg^Em, Hhd, Gg, Gs, Gs^Vo, Gg^Efm, Gg^Efm, Re, Gd, Gs, Gs, Ai, Ai, Ai, Ai, Ai
Mm, Mm, Ms, Mm^Vc, Hhd, Hhd, Hh, Hh^Fmw, Hhd^Fmw, Hh, Gg, Hh, Gs, Gs, Gs, Gg, Gg, Rd, Rd, Gs, Gd^Es, Gs, Gg, Gg, Rd, Gs, Gd, Gs, Gg^Efm, Re, Gd, Gs, Gs, Ww, Ww, Ai, Ww, Ww
Ms, Ms, Aa, Aa, Gs, Hh, Hh, Hh, Hh, Hhd, Hh, Gs, Gs, Gs^Vo, Gs, Gs^Fetd, Gs^Fp, Gs, Gs, Gs, Gd^Edt, Gd, Gs, Rd^Es, Rd, Gs, Gs, Gd, Gs, Re, Gs, Gs, Gs^Efm, Gg, Gg^Efm, Ww, Gs, Gs
Ai, Ms, Ww, Aa, Gg, Hh, Hh, Hh, Hh, Hh, Hh, Gg, Ww, Gs, Gs, Gs, Gs^Fp, Gs^Efm, Gs, Gd, Gs, Gs, Gs, Gs, Gs, Gs, Gs, Gd, Gg, Re, Gg^Efm, Gg^Efm, Gg^Efm, Gg^Efm, Gg, Gg, Gg, Gg
Ai, Ai, Ww, Ww, Ww, Ww, Ww, Ww, Wwr, Ww, Ww, Ww, Ww, Ww, Wwr, Gs, Gs, Gs^Efm, Gs, Gs, Gg, Gs^Vc, Hh, Hh, Hh, Ha, Ha, Gs, Gs, Re, Re, Gs, Aa, Gg, Gs, Gs, Gs, Gd
Ms, Ms, Ms, Ww, Ha, Ai, Ww, Ww, Hh, Ww, Gg, Ww, Ww, Ww, Ww, Gg^Efm, Gg^Efm, Gs, Gs, Rd, Rd, Gg, Gg, Gg, Gg, Hh, Ha, Ha, Aa^Voa, Aa, Aa, Aa, Aa, Gs^Vo, Gs, Gs, Gs, Gd
Ms, Ms, Ms, Ha, Hh, Hh, Hh, Hh, Hh, Hh, Gs, Gs, Gs, Gg, Gs, Ww, Ww, Gg^Efm, Gg^Efm, Gs, Gg, Gs, Gs^Edt, Gs^Edt, Gd^Edt, Gg, Gg, Aa, Gd, Aa, Gd, Re, Gd, Aa, Gs, Gs, Gs, Gs
Ms, Ms^Xm, Ms, Hh, Hh, Hh, Hh, Hh^Vo, Hh, Hh, Hh, Gs, Gg^Efm, Gd^Em, Gs, Gg, Ww, Ww, Gg^Efm, Gs, Gs, Gs, Gs^Edt, Gs^Vo, Gd^Edt, Gd^Edt, Gd^Edt, Gg, Gs^Edt, Gg, Gd, Re, Re, Gg^Efm, Gg^Efm, Gs, Gg^Efm, Gg^Efm
Ms, Ms, Ms, Hh, Hh, Hh, Hh, Hh, Hhd, Hh, Hh, Hh, Hh, Gg, Gg, Gg, Gs, Ai, Ai, Gg^Efm, Gs, Gs^Edt, Gs, Gs^Edt, Gs, Gs, Gs, Gd, Gd, Gg, Gs, Gs, Gs, Re, Rd^Es, Gg^Efm, Re, Re
Ms, Ms, Ha, Hh, Hh, Hh, Hh, Hh, Hhd, Hh, Hh, Hh, Hh, Gs, Gg^Efm, Gg, Gs, Gs, Gs, Ai, Ww, Gs, Ww, Gg, Ww, Gg, Gg^Efm, Gs, Gs, Gs, Gs, Gs, Gg, Gs, Gs, Re, Gs, Gs
Ms, Ms, Ha, Ha, Ha, Ha, Hh, Hh, Hh, Hh, Hh, Hh, Hh, Gs, Gg^Efm, Gg, Rd, Rd, Gs, Gs, Gg, Ww, Ww, Ww, Ww, Ww, Ww, Ww, Ww, Gs, Ww, Ww, Ww, Ww, Ww, Gg, Wwr, Ww
Ms, Ms, Ha, Ha, Ha, Ha, Hh, Hhd^Edt, Hh, Hh, Hh, Chr, Chr, Gs, Gg, Gg^Efm, Gg^Efm, Gg^Efm, Gg, Gd, Gs, Gg, Gs, Ww, Gg, Ww, Ww, Ww, Ww, Wwf, Ww, Ww, Chw, Ww, Chr, Ww, Ww, Ww
Ms, Ms, Hhd, Hh, Hh, Hh, Hh, Hh^Edt, Chr, Chr, Hh, Hh^Edt, Gs^Edt, Gs, Gs, Rd, Gs, Gg^Efm, Aa, Gd, Gd, Gs, Gs, Gs, Gs, Gg, Gs, Ww, Gs, Gg, Chr, Chw, 1 Khr, Chr, Gg, Gg, Chw, Ww
Ms, Ms, Hhd, Hhd, Mm, Hh, Chr, Hh, Chr, Chr, Chr, Chr, Gs, Gs^Vo, Gs, Rd, Gs, Gs, Gs, Aa^Em, Aa, Gs^Vo, Aa, Gs^Edt, Gs^Edt, Gs, Gs^Edt, Gg^Efm, Gg^Efm, Gs^Edt, Gs^Edt, Chr, Gs^Edt, Gs, Gs, Chr, Gd, Gg
Ms, Ms, Ms, Hhd, Mm, Hh, Hhd, Hh, Hh, 2 Khr, Hh^Edt, Gs^Edt, Gs^Edt, Gs^Edt, Gs, Rd, Rd, Gs, Gd, Gd, Gd, Aa^Es, Aa, Aa, Gs, Gs^Edt, Gs, Gg^Efm, Gs, Gs^Edt, Gs, Gs^Edt, Gs^Vo, Gs^Edt, Gd, Gd, Gs, Gs
Ms, Ms, Mm, Mm, Ha, Mm, Ha, Hhd, Hh, Hh, Gs^Edt, Gg^Efm, Gg^Efm, Gs, Gs, Gs^Vo, Rd, Gs, Gs, Gg, Gg, Gg, Gg, Gg, Gs, Gs^Vc, Gg, Gs, Gd, Gs, Gs, Gs, Gg^Efm, Gs, Gs, Gs, Ha, Ha
Ms, Ms, Ms, Ms, Ms, Ha, Ha, Ha, Hh, Hh, Gs, Gs, Gs, Gs, Gs, Rd, Gs, Gs, Gs, Gs^Es, Gs, Gs, Gs, Gs, Gs, Gs, Gs, Gs, Gs, Gd, Gg^Efm, Gg^Efm, Aa, Aa, Aa, Ha, Ha, Ha
