Aa, Aa, Aa, Aa^Fpa, Aa^Fpa, Aa^Fpa, Aa^Fpa, Aa^Fpa, Aa^Fpa, Aa, Aa, Gg, Gg, Gg, Gs, Gs, Gs, Gg, Gs, Gs, Gs, Gs, Gs, Gs, Ww, Gg^Efm, Gg^Efm, Gg^Efm, Gs, Aa, Aa, Aa, Aa, Aa, Aa, Aa, Aa, Aa, Aa^Fpa, Aa, Aa, Aa
Aa, Aa, Gg, Aa, Aa^Fpa, Aa^Fpa, Aa, Gd, Gs, Gs, Gs, Gs, Gs, Gs, Gs, Gs, Gg, Gg, Gg, Gg, Gg, Gs, Gs, Gs, Gs, Ww, Gg^Efm, Gg^Efm, Gs, Gg, Gg, Aa, Gg, Gg, Gs, Gs, Gs, Aa, Aa^Fpa, Aa^Fpa, Aa^Fpa, Aa
Gg, Gg^Efm, Aa, Aa, Aa^Fpa, Aa^Fpa, Gd, Gd, Gs, Gs, Gg^Vo, Gs, Gd, Gd, Rd^Em, Gg, Gd, Gg, Gs^Efm, Aa, Gs, Gs, Gs, Gg^Vo, Gs, Ww, Ww, Gg^Efm, Gg^Efm, Gs, Gs, Gg, Hhd, Hhd, Gg, Gg, Aa, Gs, Gs, Gg, Gs, Aa
Gg, Gs, Aa, Aa, Aa^Fpa, Gg, Gg, Aa^Fpa, Gg, Gs, Gs, Gs, Gg, Rd, Rd, Gg, Gd, Gs^Fmw, Gg, Gs, Gs, Gs, Gs, Gs, Aa, Gs, Wwf, Gg^Efm, Gg^Efm, Gg^Efm, Gs, Gs, Gs, Hhd, Gs, Gg, Aa, Gg, Gg, Gs, Gs, Aa
Gg, Gs, Gs, Aa, Gg, Gg, Gs, Gs, Gs, Gs, Gg, Gs, Gs, Gg^Efm, Rd, Gd, Gs, Gd, Gd, Gs, Aa^Fpa, Aa, Aa, Aa, Aa, Aa, Gs^Edt, Wwf, Wwf, Gg^Efm, Gs, Gg, Gs, Gs, Gd, Gs, Aa, Gg, Gg, Gg, Gs, Gd
Gg, Gs, Gs, Gg, Gs, Gs, Gs, Gs, Gs, Gg, Gs, Gs^Edt, Gs^Edt, Gg, Rd, Gs, Gs, Gg, Gg, Gg, Aa, Aa, Aa, Co, 3 Ko, Co, Gs^Edt, Gg, Ww, Gs^Vo, Gs, Gg, Gs, Gs^Es, Gs, Gd, Gd, Gg, Gd, Gg, Gs, Gd
Gg, Gs, Gs, Gs, Hh, Hhd, Gs, Gs, Gs, Gd^Vc, Gs, Gg^Ecf, Gs^Edt, Gg^Edt, Rd, Aa, Gs, Gg, Gg^Vo, Gs, Gs, Gs, Aa, Co, Co^Edt, Co^Edt, Gg^Vo, Gg, Gg, Wo, Gg, Gg, Gg, Gs, Gs, Gd, Gg^Efm, Gd, Gg, Gs, Gs, Gd
Gg, Gs, Gg, Ww, Hhd, Hhd, Gs, Aa^Fpa, Hhd, Gs^Edt, Co^Edt, Gs, Mm, Gg, Rd, Gs, Gs, Gs, Gs, Gs, Gs, Gg^Edt, Gg^Edt, Co, Co, Co, Gs^Edt, Gs, Gg^Edt, Ww, Ww, Gs, Gg, Gg^Vo, Gs, Gg, Gg, Gg, Gg, Gg, Gs, Gg
Gs, Gs, Gg, Ww, Hh, Gg^Vo, Gs, Aa^Fpa, Hhd^Fpa, Co, 5 Ko, Co^Edt, Ms, Ms^Xm, Ms, Aa, Aa, Gs, Gg, Gg, Gg, Gs^Ecf, Gs^Edt, Gg^Edt, Co^Edt, Aa^Fma, Aa^Fma, Gs^Edt, Gs, Gs, Ww, Gg, Gg, Gs, Gs, Gs, Gg, Gg, Ww, Gg, Gs, Gg
Gs, Gs, Gs, Wwr, Hh, Gs, Aa^Fpa, Aa^Fpa, Co, Co, Co, Co, Co, Ms, Mm, Mm^Fpa, Aa^Fpa, Aa, Aa, Aa^Fpa, Aa^Fpa, Gg^Edt, Gs^Edt, Co^Edt, Co^Edt, Co, Aa^Fma, Aa^Fma, Aa^Fma, Aa^Fma, Aa^Fma, Ww, Aa^Fma, Gg, Gg, Gg, Wo, Wo, Wo, Gd^Vc, Gs, Gs
Gs, Gs, Gs, Hh, Gs, Gs, Gd^Edt, Hhd, Ai, Ai, Hhd, Mm, Mm, Mm, Ms, Ms, Ms, Aa^Vca, Hh, Hh, Hhd, Hhd, Gs, Gd, Gd, Aa^Fma, Wo, Aa^Fma, Gs, Gs, Gg, Aa^Fma, Ww, Gg, Ww, Gg, Gg, Ww, Ww, Ww, Gg, Gs
Gs, Aa, Gs, Gs, Gd^Edt, Gd^Edt, Ai, Ai, Ai, Ai^Edt, Gs, Gs, Gs, Mm, Gs, Ms, Gs, Gd, Gd, Gs, Gd, Hh, Hhd, Gd, Gd, Gs^Edt, Wo, Wo, Gs, Gs, Gs, Gs, Gs^Edt, Ww, Gg, Ww, Ww, Ww, Gg, Gg, Gs, Gg
Gs, Gs, Gg, Gs, Gs^Edt, Gd, Ai, Ai, Ai, Ai, Gs, Gg^Vo, Gs, Gs, Gg, Gs, Hh, Gs, Hh, Gd, Gs, Gd, Gd, Gd, Gs, Gs, Wo, Gs, Gs, Gs^Vl, Gs, Gs^Edt, Co, Gs, Aa, Gg, Gg, Wwr, Ww, Gg, Gg, Gg
Gg, Gg, Gs, Gs^Edt, Gs^Edt, Gs, Gg, Gg, Aa, Gg, Gs, Gs^Fmw, Gs, Gg, Gg, Hh, Gs, Ha, Gs, Gs, Gg, Gs, Gd, Gd, Gs, Ww, Wo, Gs, Gs, Gs, Gs^Edt, Co^Edt, 4 Ko, Co, Aa, Gs, Gs, Gg, Gs, Ww, Ww, Gs
Aa, Gs, Gs, Gs^Edt, Gs, Gg^Edt, Gg^Edt, Aa, Wo, Aa, Aa, Gs, Gs, Gg, Gg, Gs, Gs, Gs, Gd, Gg, Aa, Gg, Gg, Gs^Em, Gs, Ww, Gs, Ww, Aa, Aa, Aa, Co, Co, Co, Aa, Gg^Vo, Gs, Gg, Gs, Gs, Ww, Gs
Aa, Aa, Gs, Gs, Gs, Gg^Edt, Gg, Aa, Aa, Aa, Gs, Gs, Gg^Efm, Gs, Gs, Gs, Gs, Gg^Vo, Gs, Gd, Gs^Edt, Aa, Aa, Gg, Gs, Ww, Gs, Gs, Gs, Aa, Aa, Co, Co^Edt, Co^Edt, Aa, Gs, Gs^Ecf, Gs, Gs, Gs, Gs, Ww
Aa, Gs, Gs, Gs, Gs, Gs, Gs, Gg, Ww, Gg^Efm, Gg^Efm, Gg^Efm, Aa, Gg^Efm, Gg^Efm, Gs, Gs, Gs, Gs, Gd, Gd^Edt, Gd^Edt, Aa, Gg, Gg, Gs, Rd, Gs, Aa, Aa, Gs, Aa, Re^Edt, Aa, Gg, Gg, Gs, Gs, Gs, Gs, Gg, Ww
Aa, Aa, Gs, Gd, Gs, Gs, Gs, Gg, Aa, Ww, Aa, Aa, Aa^Fpa, Gg^Efm, Ww, Gg^Efm, Gg^Efm, Gs, Gs^Edt, Gd^Edt, Gs^Edt, Gd^Edt, Gd^Edt, Aa, Aa, Gg, Rd, Gs, Gs, Gs, Gs, Gg, Re, Gs, Gs^Edt, Gs, Gs^Edt, Gs, Gs, Gs, Gg, Ww
Gg, Gg, Gs^Efm, Gd, Gs, Gg^Vo, Gs, Gg, Gg, Ww, Ww, Aa, Aa, Ww, Gs, Gg^Efm, Aa^Fpa, Gg^Efm, Gs, Gs^Edt, Gs, Gs, Gs^Edt, Gs^Edt, Aa, Gg, Rd, Gs, Gs^Fmw, Gs, Re, Re, Aa^Vha, Gs, Gd^Edt, Gd^Edt, Gd, Gg, Gs, Gs, Gs, Gg
Gg, Gg, Gg, Gd, Gs, Gs, Gs, Gs, Gs, Gg, Gg, Aa, Gs, Gs, Gg^Efm, Gg^Efm, Gg^Efm, Gg^Efm, Gg^Efm, Gs, Gg, Gs, Gs^Edt, Gs, Gs^Edt, Gs, Gg, Rd, Re, Re, Gs, Gd, Gd, Gd, Gd, Gd, Gd, Gg, Gs, Gs, Gs, Gs
Gs, Gs, Gg, Gd^Es, Gs, Gs, Gs^Efm, Gs, Gd, Rd, Rd, Gs, Gs, Gs, Gs, Aa^Vha, Gg^Efm, Gg^Efm, Gs, Gs, Gs, Gg^Edt, Gs, Gs^Edt, Gg, Gg^Edt, Gg^Edt, Gs, Gs, Re, Gs, Gs, Gd, Gd, Chr, Gd, Gg, Gg, Gd, Gs, Gs, Gs
Gg, Gs, Gs^Efm, Gd, Gd^Efm, Gs^Efm, Gs^Efm, Gs^Efm, Re, Gd, Rd, Gs, Chr, Chr, Gs, Gg^Efm, Gs, Gd, Hh^Fp, Hh^Fp, Mm, Gg, Gg, Gs, Gg, Gs^Vo, Gs, Gs, Gs, Gs, Gs, Gs, Gd, Khr, Chr, Gd, Gg, Gg, Gd, Gd^Es, Gs, Gs
Gg, Gs, Gs, Gd^Efm, Gd, Gd, Re, Re, Re, Rd, Chr, Chr, Gg, Gg, Gg, Gs, Gs, Gs, Hh^Fetd, Mm, Ms, Hh, Rd, Rd, Gs, Gs, Gs, Gs, Gs, Gs, Gd, Gd, Gd, Chr^Edt, Gd, Gd, Gg, Gg, Gg, Gg, Gg, Gs
Gg, Gg, Gs, Gs, Rd, Re, Gg, Gg, Re, Chr, Khr, Chr^Edt, Khr, Gg, Gs, Gg, Gs, Gs, Gs, Gs, Gg, Mm, Rd, Rd, Gs, Gg, Gs, Gs, Gg^Efm, Gs, Gd, Gd, Chr, Chr, Gd, Gd, Gg^Edt, Gg^Edt, Gg, Gs, Gs, Gg
Gg, Rd, Rd, Rd, Gs, Gg, Gs, Gg, Re, Chr^Edt, Gs, Gs, Gs, Gs, Gs, Gs, Gs^Efm, Gg^Efm, Gg^Efm, Gg^Efm, Gg, Rd, Gd, Gs, Gg, Gs, Gs, Gs, Gg^Efm, Gs, Gs, Gd, Chr, Gd, Gd, Gd^Edt, Gg, Gg, Gs, Gs, Gs, Gs
Rd, Rd, Gs, Gs, Gd, Gg^Vo, Gs, Gg, Re, Chr^Edt, Rd, Gs, Gs, Gs, Gg, Gg, Gg, Gs, Gs, Gs, Gd, Rd, Gd, Gs, Gg, Gd^Vc, Gs^Efm, Gs, Gg^Efm, Gs, Rd, Rd, Gg, Gd, Gd, Gs^Edt, Gs, Gs, Gg^Vo, Gs, Gg, Gs
Gg, Gg, Gs^Fmw, Gs, Gd, Gs, Gs, Gg, Gd, Re, Hh, Rd, Hh, Hh, Ms, Hh, Hh, Gg^Efm, Gd, Gs, Gg, Gd, Gg, Gg, Gs, Gs, Gg^Efm, Gg^Efm, Rd, Rd, Gg, Gg, Gg, Gs, Gd, Gs, Gs, Gs, Gs, Gs, Gg, Gg
Gg, Gg, Gs, Gs, Gd, Gs, Gs, Gs, Gs, Re, Hh, Rd, Mm, Hhd, Ms, Ms^Xm, Ms, Hh^Fp, Gg^Vo, Gs, Gg, Gg, Gs, Gg, Gs, Gs, Gg^Efm, Rd, Rd, Gg, Gs, Gs, Gs, Gs, Gs, Gs, Gs, Gs, Gg, Gg, Gg^Efm, Gs
Gs, Gg, Gs, Gs, Gd, Gs, Gs, Gd, Gs^Vo, Hh^Fpa, Mm, Mm, Mm, Mm, Hhd, Ms, Gd, Hh^Fp, Gd, Gd, Gs, Gs, Gd^Edt, Gs^Edt, Gs, Rd, Gg^Efm, Gs, Gg^Efm, Gs, Gs, Gs, Gs, Gs, Gs, Gs, Gd, Gg, Gs, Gg, Gs^Efm, Gg^Efm
Gs, Gg, Gg, Gg, Gs, Gd, Gs, Gs, Hh^Fpa, Hh^Fpa, Hh, Hh^Fp, Ms, Hhd, Gd, Hhd, Gd, Gd, Gd, Gs, Gs, Gd, Gs, Gs^Edt, Gs^Vl, Rd, Gs^Es, Gg^Efm, Gg^Efm, Gg^Efm, Gs^Vo, Hh, Hh, Gs, Gs, Gs, Gd, Gs, Gs, Gs, Gs^Efm, Gs^Efm
Gs, Gs, Gg, Gg, Gg, Gg, Gs, Gs, Gs, Hh, Hh, Ms, Ms, Ms, Gd, Gd, Gs, Gs, Gs, Gs^Em, Gs, Gs, Gs, Gs, Gs, Rd, Gs, Gs, Hh, Hh, Ms, Hh, Ha, Ha, Gg, Gs, Gs, Gd, Gs^Efm, Gs, Gs^Efm, Gg^Efm
Ha, Gs, Gs, Gs, Gs, Gs, Gs, Gs, Gs, Hh, Gs, Ms, Gd, Gd, Gg, Gg, Gg^Efm, Gs^Efm, Gs^Efm, Gs, Gd, Gs, Gg, Gs, Gg, Rd, Gs, Hh, Gs, Hh, Hh, Hhd, Hh, Ha, Gg, Gs, Gs, Gs, Gs, Gs, Gs^Efm, Gs^Efm
Ha, Ha, Ha, Ha, Ha, Ha, Ha, Gs, Gs, Gs, Aa, Gg, Gg, Gg, Gg, Gg, Gs, Gs, Gs, Gs^Efm, Gs, Gs, Gd, Gg, Rd, Re, Re, Gs, Gs, Gs, Gs, Gs^Vl, Hh, Mm, Mm, Gg, Gg, Gs, Gd, Gs, Hh, Gs
Mm, Mm, Mm, Mm, Mm, Ha, Gs, Gs, Gs, Gs, Aa, Gs, Rd, Gs, Gs, Gs, Gg, Gs^Edt, Gs^Edt, Gs, Gs, Gs, Gs, Gd, Gd, Gs^Fmw, Gg, Re, Re, Gs, Gd, Gd, Gd, Hhd, Hhd, Hh, Gg, Gg, Gd, Gs, Hh, Gs
Ha, Ha, Ha, Hhd, Ha, Ha, Gs, Gg^Vo, Aa, Aa, Gg, Gs, Gs, Gs, Gg, Gs, Gd^Vc, Gs, Rd, Rd^Edt, Rd^Edt, Gg^Vo, Gs, Gs, Gd, Gd, Gs, Gg, Gg, Re, Re, Gd, Gg, Aa, Aa, Ms, Ms, Gg, Gs, Hhd, Gs^Efm, Gs
Ha, Ha, Hhd, Ha, Ha, Ha, Gs, Gs, Gs, Gs, Gd, Gg^Efm, Gg, Gs, Aa, Gs, Aa, Gs, Chr, Chr, Gd^Edt, Gs^Edt, Gs^Edt, Gs, Aa, Gd, Gg^Efm, Gg, Gs^Efm, Gg, Gg, Rd, Gg, Gg^Efm, Rd, Aa, Aa, Gs, Ha, Aa, Gs, Gs
Mm, Mm, Ms, Ms^Xm, Ms, Ha, Ha, Gs, Gs, Gd, Gd, Gd, Gg, Gs, Gs, Gs, Gs, Aa, Chr, 1 Khr, Chr, Gs^Edt, Aa, Aa, Ms, Gs, Gs, Gs^Efm, Gs, Gg, Gg, Rd, Gs, Gg^Efm, Gg^Efm, Aa, Ha, Ha, Aa, Ha, Gs, Gs
Ms, Ms, Ms, Ms, Ms, Ms, Ha, Ha, Ha, Gd, Hh, Gd, Gd, Gg, Ha, Gs, Hh^Edt, Aa, Chr^Edt, Chr, Ms, Aa, Aa, Ms, Ms, Hh, Gs, Gs, Gs, Gs, Gs, Rd, Gg, Gg, Aa, Aa, Ha, Ha, Ha, Ha, Ha, Gs
Ms, Ms, Ms, Ms, Ms, Ms, Mm, Mm, Mm, Hhd, Hhd, Hhd, Ha, Ha, Ms, Ms^Xm, Ms, Hh^Edt, Chr^Edt, Chr, Chr, Ms, Ms, Ms, Gg, Mm, Hh, Hh, Hh, Gs, Hh, Re, Aa, Aa, Ha, Ha, Mm, Hhd, Hhd, Ha, Ha, Ha
Ms, Ms, Ms, Ms, Ms, Ms, Ms, Mm, Ms, Mm, Mm, Hhd, Ms, Ms, Ms, Ms, Mm, Gg^Vo, Chr, 2 Khr, Chr, Ms, Ms, Ms, Ms, Mm, Ms, Mm, Ms, Hh, Mm, Rd, Ha, Ha, Mm, Mm, Mm, Mm, Mm, Mm, Mm, Mm
Ms, Ms, Ms, Ms, Ms, Ms, Ms, Ms, Ms, Ms, Ms, Ms, Ms, Ms, Ms, Ms, Ms, Mm, Mm, Chr, Ms, Ms, Ms, Ms, Ms, Ms, Ms, Ms, Ms, Ms, Mm, Mm, Mm, Mm, Mm, Mm, Mm, Mm, Mm, Mm, Mm, Mm
