Mm, Hh, Hhd, Hh^Fdw, Gs^Fdw, Gg, Aa, Ai, Hh, Hh, Hh^Fmw, Hh, Mm, Hh, Mm^Xm, Hh, Hh, Mm, Mm, Mm, Mm, Hhd, Hhd, Mm, Hh^Fmw, Gs^Fdw, Gs^Fp, Gg, Gs, Gd^Es, Gs^Es
Hh, Mm, Mm, Hh^Fdw, Gs^Fmw, Gg, Gs^Es, Ai, Hhd^Em, Hhd, Hhd^Fmw, Mm, Mm, Mm, Mm, Hhd^Em, Hh^Em, Mm, Mm, Mm, Mm, Mm, Mm, Hh, Hhd^Fdw, Gs^Fmw, Gg^Efm, Gg, Gs^Es, Aa, Gs
Mm, Mm, Mm, Hhd, Gs^Fp, Gs^Fp, Gll, Ai, Hh, Aa, Mm, Mm, Mm, Mm, Mm, Mm, Mm, Mm, Mm, Mm, Hhd, Mm, Aa, Hh, Gg, Gg^Efm, Co, Co, Co, Aa, Gg
Hhd, Mm, Mm, Mm, Gg, Gg, Co, Wwr, Wwr, Gll, Gs^Fdw, Mm, Mm, Mm, Mm, Mm, Mm, Mm, Mm, Mm, Aa, Gd^Es, Gs, Gs, Co, Gg^Es, Co, 3 Ko, Co, Aa, Gg^Efm
Hh, Hhd, Hh, Aa^Voa, Gd, Co, 4 Ko, Co, Ww^Wkf, Gll, Gg, Gs^Fp, Gs^Fmw, Mm, Mm, Mm, Mm, Hhd^Em, Hhd^Emf, Mm, Aa, Gs, Aa^Voa, Gg, Ko, Co, Co, Co, Gg, Gg^Efm, Gs^Fp
Hh, Hhd^Fmw, Aa, Aa, Gs, Co, Ko, Co, Co, Ww^Wkf, Ww^Ewl, Gg, Hhd^Fmw, Hh^Fdw, Hhd^Em, Mm, Mm, Mm, Mm, Hhd^Em, Aa, Gg, Gg, Gg, Gs^Fdw, Gg, Gg, Gg, Gg, Hh^Fmw, Hh
Hh, Hh, Hh, Hhd, Gg, Co, Aa, Aa, Aa^Voa, Ww^Ewf, Hhd, Ww, Hh, Hhd, Mm, Mm^Xm, Mm, Mm, Gs^Fmw, Hhd^Fdw, Gg^Efm, Gs, Gs^Fp, Gs^Fmw, Hh^Fmw, Gs^Fdw, Gg, Gd^Vo, Gs, Mm^Xm, Hh
Hhd, Mm, Mm, Hhd^Em, Hhd, Gg, Gs, Co, Gs, Aa, Gll, Wwr, Hh, Hhd^Fdw, Hh^Fmw, Mm, Gg, Gs^Fmw, Gs^Fp, Gg, Gg^Efm, Gg, Hh, Hh^Fdw, Gg, Hh^Fmw, Gg^Efm, Gs, Gd, Hhd^Fmw, Hhd
Hh, Hhd, Hh^Fmw, Mm, Mm, Gg, Gg^Efm, Gs, Gg, Gg, Wwr, Wwr, Hhd, Aa^Voa, Gg, Gs^Fdw, Gg, Gs^Fdw, Gs^Es, Aa, Aa, Gg, Gg, Gg, Hh, Gg^Efm, Mm, Mm, Mm, Mm, Hh
Hh, Hh^Fmw, Mm, Hhd^Emf, Hhd^Em, Gg^Efm, Gg, Gg, Gg, Aa, Ww^Wkf, Hhd, Gll, Gg, Ww, Gll, Gll, Gs, Gg, Gs, Aa, Aa, Gg, Hh, Mm, Mm, Mm, Mm, Mm, Mm^Xm, Mm
Mm, Mm, Mm, Mm^Xm, Mm, Mm, Gs, Aa^Voa, Gg, Aa, Aa, Ww, Ww^Wkf, Wwr, Gd^Es, Ww^Ewl, Gg^Efm, Gg^Efm, Aa, Gg^Efm, Gg, Gg, Hh^Fmw, Hh^Fdw, Mm, Mm, Mm, Mm, Mm, Mm, Hhd
Hh, Hhd, Hhd^Fmw, Mm, Aa^Voa, Aa, Gd^Es, Gs, Gg, Gg, Hhd^Em, Hhd, Ww^Wkf, Gll, Gg, Gg, Aa, Aa, Hh, Aa, Gs^Fdw, Gs^Fdw, Gs^Fmw, Mm, Mm, Mm, Mm, Mm, Mm, Mm, Mm
Gs^Fp, Hh^Fmw, Hhd^Fmw, Mm, Aa, Aa, Gs, Gs, Gs^Fdw, Gs^Fmw, Hh^Fdw, Co, Ww^Ewl, Ww^Wkf, Ww, Gs, Gs, Aa, Mm, Hh, Hhd^Em, Gg, Gg, Gs^Fdw, Hh, Mm, Mm, Mm, Hh^Fmw, Mm, Hhd
Gs^Fdw, Gs^Fmw, Gd^Es, Aa, Hhd^Em, Gg^Efm, Gg, Gg, Gs^Fdw, Gs^Fmw, Hh^Fdw, Co, Ww, Hhd^Em, Gll, Gg, Mm, Mm, Mm, Mm, Mm, Hh^Fmw, Hh, Gg, Gg, Hh, Hhd, Hhd, Gs, Hh, Hh^Fmw
Hh^Fdw, Gg, Gg, Gg, Hhd, Gg, Gd^Vo, Gd, Gg, Hh^Fdw, Aa, Hhd, Ww^Wkf, Hhd, Gg, Gg, Hh, Mm, Mm, Mm, Mm, Mm, Aa^Voa, Aa, Gs, Gd^Vo, Gs, Gs, Aa, Co, Co
Hh, Hh^Fdw, Hh, Hhd, Gs, Gs, Gg, Gg, Gs, Gs, Aa, Hhd^Em, Hhd^Emf, Hhd^Em, Gg, Gg^Efm, Gg, Mm, Gg^Efm, Hh, Aa, Hh, Aa, Aa, Gs, Gg, Gll, Ai, Ai, Ai, Ai
Hhd, Hhd, Gs, Gs, Gd^Es, Hhd, Gg, Gg, Gs, Gd^Es, Ww^Ewl, Ww^Wkf, Ww, Ai, Aa, Gd, Gs, Gg, Gg, Hh, Aa, Aa, Gs, Gs^Es, Gg, Gll, Ww^Wkf, Ww^Wkf, Hhd, Hhd^Fmw, Hhd^Fdw
Hhd, Hh, Gg, Gg^Efm, Gg, Gd^Es, Gg, Gg, Mm, Gs, Gg, Gll, Gg, Ai, Ai, Aa^Voa, Ww, Gll^Es, Gll^Es, Gg, Gg, Gg, Ww^Ewf, Gg, Gll, Gll^Es, Wwr, Hh^Em, Hh, Hh, Hh
Gg, Gg, Hhd, Gg^Efm, Gs^Fdw, Hh, Mm, Mm^Xm, Mm, Hhd, Aa, Gg^Efm, Aa, Gg, Gll, Ww^Ewl, Hh, Wwr, Wwr, Gll, Co, Hh, Ww^Wkf, Ww^Ewl, Wwr, Wwr, Hhd, Hh^Em, Mm, Mm^Xm, Mm
Gs^Fdw, Hh, Hh^Fmw, Gg, Gs^Fp, Hh^Fdw, Hhd^Fdw, Mm, Hhd^Em, Hh^Fdw, Mm, Gg, Aa, Gg, Gll, Ww^Ewf, Hhd^Em, Hh^Fmw, Ww^Wkf, Co, Ww, Ww^Ewl, Hhd, Hh, Hh^Fmw, Hhd^Fdw, Hhd^Fdw, Hh, Mm^Xm, Mm, Mm^Xm
Gs, Hh^Fdw, Gs^Fp, Gg, Hh^Fdw, Mm, Hh^Em, Hhd^Emf, Mm, Mm, Mm, Mm, Hh, Aa, Gs, Gll, Hhd^Emf, Hhd^Fdw, Ww, Ww, Co, Wwr, Ww^Wkf, Gs^Fdw, Gs^Fdw, Gs^Fmw, Gg, Mm, Mm, Mm, Mm^Xm
Aa, Gs^Es, Gs^Fp, Gg, Hhd, Hh, Gs^Fdw, Mm, Mm, Mm, Hh^Fdw, Mm, Aa^Voa, Aa, Gs^Es, Hh^Em, Hh^Em, Ww, Hhd^Em, Co, Gg, Gg, Gg^Efm, Gg^Efm, Gg^Efm, Gg, Hhd, Mm, Mm, Mm, Mm
Aa, Gs^Es, Gg^Efm, Gg, Gg, Gg, Gs^Fdw, Hh^Fdw, Hh^Fmw, Hhd, Gs, Gg, Gs^Es, Gs, Gg, Gg, Hhd, Wwr, Gll, Gg, Gs^Fp, Hh, Hhd, Aa, Aa, Hhd, Hhd, Mm, Mm, Mm, Mm
Aa, Gs, Gg, Gg, Aa, Gs, Gs^Es, Gs^Fmw, Gs^Fdw, Gs, Co, Co, Co, Gg, Hh, Hhd^Fmw, Hh, Ww^Wkf, Gs, Gg, Gs^Fp, Hh^Fdw, Hh^Fmw, Hhd, Hhd^Em, Aa, Hh, Mm, Mm, Mm, Mm
Ai, Ai, Ai, Aa, Ai, Aa, Gs, Gd^Vo, Gg, Gg, Co, 5 Ko, Co, Ww, Ai, Hh, Ww, Ww^Ewl, Gs, Gg, Gg, Gs^Fmw, Hhd, Hh^Em, Hhd^Em, Aa, Gg, Hh, Hhd, Mm, Mm
Co, Co, Aa, Ai, Gll, Gs, Gs^Fdw, Gg, Gg, Gg, Ww^Ewl, Ww^Ewf, Co, Co, Aa, Ai, Gll, Gd, Gg, Gg, Gd, Gs, Hh, Hh^Fdw, Aa, Hh, Gg, Gg, Hhd, Hhd, Hh
Gg, Gd, Gs^Es, Ww^Ewl, Gll, Gg, Wwr, Wwr, Ww^Wkf, Ww^Wkf, Gll, Ko, Gd^Es, Aa, Co, Co, Gg^Efm, Gg, Gg, Aa^Voa, Gs, Gd^Es, Aa, Aa, Aa, Aa, Aa, Hh, Gg, Aa, Aa
Hhd, Gs^Fdw, Gs^Fp, Ww^Wkf, Ai, Ww, Hh, Hhd, Hhd^Em, Hhd, Gg, Gs, Gs, Aa, Gg, Gg^Efm, Hh, Gg^Efm, Gs^Fp, Gg, Gg^Efm, Gs, Gg, Gs, Gs, Gd^Es, Gs, Gg, Hh^Fmw, Hh, Hhd
Hhd, Hhd^Fmw, Gs^Fmw, Gll, Aa, Hh, Gs^Fdw, Hh^Fmw, Hhd^Fdw, Gg, Gll, Gll, Hh, Gg, Hh, Hh, Hhd^Em, Gs^Fdw, Gs^Fmw, Gs^Fp, Hh, Gg^Efm, Aa, Aa, Gg, Gs^Ecf, Gg, Gg, Gg, Gs^Fp, Gs^Fp
Hh^Fdw, Hhd^Em, Hhd^Em, Gg, Gg, Gg^Efm, Gs^Fdw, Hh^Fmw, Gs^Fmw, Gs^Fp, Gll, Hhd, Mm, Hhd, Mm, Mm, Mm, Hhd^Fmw, Hh, Gs^Fdw, Hh, Hhd, Aa, Hhd, Gg, Gg, Chr, Chr, Chr, Gg^Efm, Gg^Efm
Mm, Mm, Mm, Hh, Hh, Gg, Gg, Gs^Fdw, Gg, Gs^Fp, Gg, Gs^Fdw, Hh, Mm, Mm, Mm, Mm, Mm, Mm, Hh^Fmw, Gs^Fmw, Hhd, Hh, Gg, Gd^Vo, Gg, Chr, 1 Khr, Chr, Aa, Hhd
Hh, Mm, Mm, Mm, Mm, Hhd^Fdw, Hh^Fmw, Gg, Gs, Gs, Gs^Es, Gs^Fmw, Gs^Fmw, Hhd^Em, Hhd^Emf, Hhd^Em, Mm, Mm, Hh, Hh^Fmw, Gs^Fmw, Gg, Gg, Gs, Gd^Es, Gs^Es, Chr, Chr, Chr, Hhd^Fmw, Hhd
Hhd, Hhd, Mm, Mm, Hhd, Hhd^Fdw, Mm, Hh, Aa, Gd^Vo, Gs, Gg, Gg^Efm, Hh^Em, Gs, Gd^Es, Gd^Es, Mm, Mm, Gs^Fdw, Gg, Gll, Hhd, Hh^Fdw, Hhd^Em, Hhd^Emf, Chr, 2 Khr, Chr, Hh^Fmw, Hh
Hh, Mm, Mm, Mm, Mm, Mm^Xm, Hhd, Hhd, Aa, Aa, Aa, Gg, Hhd^Fdw, Gs, Hh, Hh^Fdw, Gll, Hh^Em, Gg, Gg^Es, Gs^Es, Hh, Aa, Aa, Aa, Hh^Em, Hh, Chr, Hhd^Emf, Hhd^Em, Hh
Mm, Hh, Hhd, Mm, Mm, Mm, Hh, Hh, Hh, Hh, Hh, Hhd, Hh, Hhd, Hhd, Hhd, Gs, Gg, Gs, Gs, Aa, Aa, Hh, Hhd^Em, Hhd, Hhd, Hh, Hhd^Em, Hh^Em, Hhd^Em, Hh
