Md, Md, Ms, Ms^Xm, Ms, Md, Ms, Ms^Xm, Ms, Ms, Mm^Xm, Ms, Md, Ms, Ms, Ms, Md, Md, Ms^Xm, Ms, Ms, Ms, Ms, Gs, Ww^Wkf, Hh, Hh, Ha, Ha, Ms, Ms, Ms, Ms, Ms, Ms, Ms, Ms, Ms^Xm, Ms, Ms, Ms, Ms
Ms, Ms^Xm, Ms, Ms, Ha, Md, Ha, Ms, Mm, Mm, Mm, Mm, Md, Md, Md, Md, Ha, Ms, Ms, Ms, Ms, Ms, Md, Md, Md, Ww^Wkf, Hh, Hh, Hhd, Ha, Ha, Ms, Ha, Ha, Ha, Ha, Ha, Ms, Ms, Ms, Ms, Ms
Md, Ms, Md, Ha, Hhd, Hh, Hhd, Hhd, Hhd^Em, Hhd^Em, Hhd^Vhhr, Hhd, Gd, Hhd^Em, Hhd^Emf, Hhd, Wo, Hhd^Dr, Hhd^Em, Ha, Hhd^Dr, Hhd^Em, Hhd, Md, Md, Ww^Ewl, Ww^Wkf, Hh, Hh, Hhd, Hhd^Em, Ha^Em, Hhd^Em, Md, Md, Md, Md, Ha, Ha, Ha, Ha, Ms
Md, Md, Md, Md, Hhd, Aa, Gd^Efm, Aa, Gll, Gll, Gll, Aa, Aa, Aa, Hhd^Em, Hhd^Em, Aa, Aa, Aa, Hhd^Dr, Aa^Em, Aa^Em, Aa, Hhd, Hhd, Md, Wwf, Hh, Hh, Hh^Em, Hhd, Hhd^Emf, Hhd^Em, Md, Hhd, Md, Hhd^Em, Md, Md, Ha, Ha, Ms
Md, Md, Hhd, Hhd, Aa^Voa, Aa, Ai, Gll^Es, Hh^Es, Md, Md, Gd, Gs, Aa^Esa, Aa^Esa, Aa^Esa, Aa, Aa, Aa, Aa, Aa, Aa, Aa^Voa, Aa, Hhd, Md, Hh, Wwf, Wwf, Hh, Hhd, Md, Hh, Hh^Em, Hhd, Hhd, Md, Md^Xm, Md, Md, Ha, Ha
Md, Md, Hhd, Aa, Aa^Esa, Ai^Esa, Md, Hh^Dr, Md^Xm, Md^Xm, Md, Md, Md, Gs^Efm, Gd^Esa, Aa^Esa, Aa, Aa, Aa, Wo, Aa, Aa, Hhd, Co, 3 Ko, Co, Hhd^Emf, Md, Wwr, Hh, Hhd, Md, Hh, Hhd^Dr, Hhd^Dr, Md, Ha, Md, Ha, Md, Ha, Ha
Hhd^Dr, Hhd, Gd, Gd, Gd^Esa, Ai, Md, Md, Md, Md, Hhd^Dr, Hh, Md, Gd^Es, Rra^Esa, Aa, Aa, Aa, Aa, Aa, Rra^Esa, Rra^Esa, Hhd^Dr, Co, Co, Co, Hhd, Md, Aa, Wwr, Md, Md, Md, Hh, Hhd^Dr, Md, Md, Ha, Md, Ha, Hhd, Ha
Hhd, Aa, Gd, Ww^Wkf, Gs^Efm, Aa, Md, Md, Md, Hhd^Em, Co, Hhd^Dr, Hhd^Emf, Rra, Aa^Voa, Aa, Aa, Aa, Aa^Esa, Aa^Esa, Rra, Gs^Efm, Hhd^Esa, Co, Co^Edb, Co^Edb, Hhd^Edb, Hh, Aa, Ww^Ewl, Wwr, Hh, Md, Hh, Hh, Md, Md, Md, Md, Md, Hhd^Em, Ms
Hhd, Aa, Gs^Efm, Ww, Gd, Wo, Wo, Md, Md, Co, 5 Ko, Co, Hhd^Em, Rra^Em, Rra^Esa, Aa, Aa^Esa, Aa, Aa, Aa, Rra, Gd, Aa^Esa, Hhd, Co, Hhd^Edb, Md, Md, Aa, Gd, Wwr, Mm^Xm, Mm^Xm, Hh, Hhd, Hhd^Vhhr, Md, Md, Wwr, Md, Hhd^Emf, Ms
Hhd, Hh, Gs, Wwr, Ai, Ai, Gll^Edb, Md, Co^Edb, Co^Edb, Co^Edb, Co^Edb, Co^Edb, Rra, Gs^Edb, Aa^Esa, Aa, Aa, Aa, Aa, Rra, Aa, Aa^Esa, Co, Co^Ebn, Co, Aa, Aa^Voa, Aa, Gs^Efm, Gll, Ww^Wkf, Mm^Xm, Md, Md, Md, Wwr, Wwr, Wwr, Ms, Hhd^Em, Hhd^Dr
Md, Hhd, Hhd, Ai, Gll, Ai, Ai, Gll^Edb, Rra, Rra, Aa^Voa, Rra, Rra, Gll^Edb, Gll, Gll^Efm, Gd, Gd, Gd^Efm, Gd^Efm, Gd^Efm, Rra^Edb, Rra, Aa, Aa^Voa, Aa, Rra, Aa^Esa, Aa^Esa, Ai, Ai, Ww^Wkf, Wwf, Md, Ww, Md, Md, Wwf, Ww^Wkf, Ww^Wkf, Md, Hhd^Dr
Md, Md, Hhd, Md, Md, Ai, Rra^Esa, Rra^Esa, Gs, Ai, Ai, Ai, Ww^Wkf, Wo, Wo, Ww^Wkf, Gs^Es, Gs, Gll, Gs, Re^Efm, Gd^Edb, Gd^Edb, Rra, Rra, Aa, Rra^Es, Ai, Aa^Esa, Aa, Aa, Aa^Voa, Md, Wwf, Md, Ww^Ewl, Ww^Ewl, Ww^Wkf, Md, Md^Xm, Md, Md
Md, Md, Md^Xm, Md, Md, Rra, Md, Md, Gs^Es, Gg^Efm, Gs, Gs^Efm, Gs, Gs, Gs^Efm, Gs^Efm, Gd, Gll, Re, Re, Wo, Re^Edb, Re, Aa, Gd, Rra^Es, Rra, Aa^Esa, Ai, Rra, Hhd^Em, Hhd, Co, Hh, Hh, Md, Hh, Wwr, Wwf, Md, Md, Md
Md, Md, Md, Md^Xm, Md, Md, Hhd^Emf, Rra, Rra, Gs^Es, Co, Co, Co, Co, Wo, Gd, Gll, Gll, Co, Co, Aa, Wo, Co, Gs, Gs, Gd, Rra, Aa, Rra, Rra, Aa, Co, 4 Ko, Co, Hh, Hh, Md, Md, Gll, Ww^Ewl, Wwr, Ms
Md, Md, Hhd^Dr, Md, Md, Md, Rra^Em, Rra^Esa, Wo, Wo, Hh^Emf, Aa, Gll, Gs, Gd, Gs^Es, Gll^Es, Co^Ebn, Aa, Aa, Hh, Aa, Aa, Co, Co, Gd, Rra, Aa, Rra, Aa, Ww^Wkf, Co, Co^Edb, Co, Hh^Edb, Md, Hh, Hh, Gll^Es, Gll, Wwr, Ms
Hhd, Hhd, Gll^Es, Gd^Vo, Hhd, Gll, Ai, Rra^Esa, Hh^Emf, Hh, Aa, Aa, Gd, Gd, Gd, Gd^Es, Gll^Edb, Rra, Aa, Gll, Gll, Hh, Hhd, Re, Gd^Vo, Gll, Gd^Es, Rra, Aa, Ww^Wkf, Hhd, Co, Co^Ebn, Co^Edb, Hhd^Dr, Hh^Edb, Aa^Voa, Gd, Gs^Es, Gll^Es, Gll, Ww
Gs, Hhd, Gd, Gll^Es, Gll^Es, Gll, Ai, Rra^Esa, Hh, Aa, Gs, Gd^Vo, Gd, Aa, Aa, Gs^Edb, Gll, Rra^Edb, Gs, Gs^Efm, Gll, Gd, Co, Re, Gll, Gll, Gd^Es, Rra, Aa, Ww^Wkf, Aa^Voa, Hhd, Hhd, Hhd^Dr, Aa^Esa, Aa^Esa, Gs^Es, Gs, Gll, Ww^Wkf, Ww, Wwr
Aa, Wo, Aa, Re, Ai, Ai, Ai, Rra^Esa, Hh, Gs, Hh, Gd, Hh, Aa, Hh, Aa, Gd, Gs^Edb, Aa, Gs^Efm, Gs^Efm, Gll, Gll, Co^Ebn, Co^Edb, Gd, Gd, Gs^Es, Co, Aa, Rra, Aa, Aa, Wo, Rra, Rra, Rra, Rra, Gd, Gll, Wo, Gll^Es
Aa, Aa, Aa, Re, Aa, Ai, Ai, Rra, Rra, Hh, Gd, Hhd, Gd, Hh, Ww^Wkf, Aa, Re, Aa^Esa, Re, Re, Gs, Gs, Gs^Es, Gd, Gd^Edb, Gd^Es, Gll^Edb, Gll^Edb, Co, Aa, Gs, Rra, Rra, Rra, Gs, Aa^Esa, Aa^Esa, Rra, Gd, Gd^Vo, Gs, Gll
Aa, Aa, Ww^Wkf, Re, Aa, Re, Ai, Ai, Rra, Ai, Ai^Esa, Gd, Aa, Aa, Aa^Esa, Aa, Re, Re^Esa, Ai, Gd, Gd, Gs^Efm, Gs, Gd, Gll^Edb, Gd^Edb, Gs, Gll^Efm, Gs^Efm, Gs^Efm, Gd^Vo, Gd, Gd, Gs, Gd, Ww, Aa^Esa, Rra, Gs, Wo, Gs^Efm, Gll
Aa, Ww^Ewl, Re, Re, Aa, Gd^Vo, Chr, Ai, Gd, Ai, Ai, Aa^Esa, Aa, Re, Aa^Esa, Re, Ai, Ai, Gll, Ai, Gd, Ww^Ewl, Wo, Ww^Wkf, Gll, Gll, Gs, Gs, Gll, Gll, Gd, Gll, Gd^Esa, Gd, Rra, Wo, Wo, Gs, Aa, Wo, Wo, Gs
Aa, Ww^Wkf, Re, Re, Re^Edb, Chw^Edb, Khr, Chr^Edb, Rra^Edb, Gd, Ai, Aa, Ai, Re, Re, Gd^Vo, Ai, Ww^Wkf, Hh, Hh, Mm, Gd, Gd, Gs, Gs, Gll, Wo, Wo, Ww^Ewl, Gd, Aa^Esa, Aa^Esa, Aa, Rra, Md, Hhd, Gll, Gs^Efm, Aa, Aa, Ww^Wkf, Gs
Aa, Re, Ww, Gd^Edb, Rra, Chw^Edb, Chw^Edb, Chr, Rra, Gll^Edb, Ai, Ai, Ai, Ai, Ai, Ai, Gd, Wo, Hh, Mm, Mm^Xm, Hh, Hh^Em, Gs, Wo, Gs, Ww^Wkf, Rra, Aa, Aa, Gd, Gd, Hhd, Rra, Md, Hhd, Gll, Gs^Efm, Gs^Efm, Ww^Ewl, Gd, Gd
Aa, Re, Wo, Rra, Gd, Rra, Rra, Rra, Gs, Gll, Gll^Edb, Gd^Edb, Gd^Edb, Gd, Ai, Ai, Gd, Gd, Ww^Ewl, Wo, Ww^Wkf, Mm, Hh, Hh^Em, Gd, Gs^Efm, Gs^Efm, Ww^Wkf, Aa, Aa^Esa, Aa, Hhd, Rra, Rra, Hhd, Gll, Gg, Gd^Vo, Gll, Gll^Es, Gd^Es, Aa
Re, Re, Gs^Efm, Gd^Vo, Gs, Gd, Gs^Edb, Gll^Edb, Gs^Edb, Gll^Edb, Gs^Efm, Gll^Edb, Ai, Ai, Aa, Ai, Rra, Rra, Rra, Gs, Gll, Hhd^Dr, Gll^Es, Gd, Gs, Gs, Gs^Efm, Aa, Gs^Esa, Aa^Esa, Hhd, Hhd^Dr, Rra, Hhd, Gd, Gd, Gs, Re, Re, Re^Esa, Aa, Aa
Gs, Gs^Efm, Gd, Gs, Gd, Gs, Gs^Edb, Gs^Edb, Gd, Gll, Gs, Gll, Gd, Aa, Aa, Aa, Aa, Aa, Aa, Rra^Es, Gll, Hh, Gll, Gd, Gll^Es, Gll, Gs, Gs, Wo, Md, Rra, Rra, Gd^Vo, Gd, Re, Re, Gs^Es, Gll^Edb, Aa^Edb, Aa^Esa, Gd^Edb, Gd^Edb
Gll, Gd, Wo, Gll^Es, Gd, Gs, Gd^Vo, Gd, Gll, Gll, Hh, Gll, Hh, Hh, Mm, Hh, Hh, Aa, Aa^Esa, Rra, Gs, Gll, Gd, Gs, Gll, Gs^Es, Gd^Es, Gd^Es, Chw, Rra, Gd^Edb, Gd, Ww^Wkf, Re, Wo, Ww^Wkf, Ww, Gs^Edb, Gd^Es, Gd^Edb, Re, Re
Gd, Gll, Gs, Gs^Edb, Gd^Edb, Gs^Edb, Gd^Efm, Gs^Efm, Wo, Ww^Wkf, Hh, Gll, Mm, Hh, Mm, Mm^Xm, Mm, Hh, Aa, Rra^Esa, Rra, Gd, Wo, Gs^Efm, Gll^Edb, Gs^Edb, Rra^Edb, Chw^Edb, Khr, Chw^Edb, Gd, Ww^Wkf, Gs, Gs, Gll, Ai, Gd, Gd, Re^Es, Re, Gs^Efm, Gs
Gg, Gs^Efm, Gd^Esa, Gd, Gd, Gs^Efm, Gs, Gs^Efm, Gll, Hh, Mm, Mm, Md, Mm, Hhd^Dr, Mm, Hh^Dr, Hh, Aa, Aa^Esa, Rra^Esa, Gs, Gd, Gs, Gll^Es, Gll, Rra, Chr, Chr, Chr^Edb, Gd^Edb, Wo, Gs, Gs, Gll, Ai^Esa, Re, Re^Es, Wo, Ww, Gll, Ww
Aa, Gd, Aa, Aa^Esa, Aa, Gd^Esa, Gs, Gll, Hh, Hhd, Hhd^Dr, Hhd^Emf, Md^Xm, Hhd^Vhhr, Md, Hhd^Dr, Aa, Aa, Rra, Aa, Rra^Esa, Gd^Vo, Gs, Gs, Gll, Ww^Ewl, Gd^Edb, Rra^Edb, Gll^Edb, Gll^Edb, Gll, Hh^Em, Hh^Em, Gs, Gll, Ai^Esa, Gd^Esa, Gll, Gll, Wo, Gll, Gll
Md, Aa, Md, Aa, Aa, Aa^Esa, Gs, Gll, Rra, Hh, Hhd, Md, Md, Md, Hh^Em, Hh^Em, Aa^Esa, Rra^Esa, Gll, Rra, Gs^Efm, Gs, Gll, Gs^Efm, Wo, Wo, Gll^Edb, Gll, Hh^Em, Hh, Mm, Hh^Emf, Hh^Em, Gd, Gd, Ai, Ai, Gd^Efm, Gd^Efm, Gd, Ai, Gll
Hh, Md, Md, Md, Md, Aa^Esa, Aa, Gs, Rra, Hh, Rra^Es, Rra^Es, Hh, Hh, Aa, Aa, Gd^Esa, Rra, Ww^Ewl, Gll, Gs^Edb, Gs, Gs^Efm, Gs^Efm, Gll, Gll, Rra, Hh, Aa, Hh, Hh^Em, Hhd^Vhhr, Hh, Hh, Gd, Ai, Ai, Ai, Ai, Ai, Aa^Esa, Ai
Hh, Hh, Hh, Hh, Hh, Hh, Aa, Aa^Esa, Aa^Esa, Rra^Es, Gd^Es, Gd^Esa, Aa^Esa, Aa, Gd, Aa, Gd, Rra, Ww^Wkf, Gll, Gs^Edb, Gs, Gd, Wo, Gll, Rra, Aa, Aa, Ww, Aa, Aa, Gd, Hh, Mm, Mm, Gd, Gd, Ai, Rra, Ai^Esa, Hh, Aa
Mm, Mm, Mm, Mm, Mm, Hh, Gd, Gll, Gd^Esa, Gd, Gll, Gd, Gd, Gd^Esa, Ww^Wkf, Gd, Gll, Rra, Wo, Wo, Gs^Edb, Gs, Gll, Gd, Rra^Es, Rra, Gs, Wo, Gs^Efm, Wo, Gd, Gd, Rra, Hhd^Em, Hhd^Emf, Hh, Gd, Ai, Aa, Aa^Esa, Hh, Hhd
Hh, Hh, Hh, Hhd^Dr, Hh^Dr, Hh^Dr, Gll, Gll, Gd^Vo, Gll, Gs^Efm, Gll, Wo, Wo, Gs^Efm, Gs^Efm, Gd^Vo, Rra^Es, Gd^Es, Gd^Es, Gll^Edb, Gll, Rra^Edb, Rra^Es, Gd^Edb, Gd, Gs, Gs^Efm, Gll, Gs^Efm, Gll, Gd^Vo, Rra, Hh^Em, Hh^Em, Mm, Mm, Gd, Aa, Hhd, Md^Xm, Md
Hh, Hh^Em, Hhd^Em, Hh^Em, Hh, Hh, Rra, Rra, Rra, Gs, Gd, Ww^Wkf, Gs, Gs^Efm, Gll, Gll, Rra, Rra, Chr^Edb, Chr^Edb, Rra^Edb, Rra^Edb, Gd^Vo, Gs^Edb, Aa^Esa, Gd^Edb, Gll^Esa, Gll, Rra, Gll, Rra^Es, Gll^Es, Rra, Aa, Md, Hh, Mm, Aa, Hh, Md, Md, Md
Ms, Ms, Md^Xm, Md^Xm, Md, Hh, Hh, Aa, Aa^Esa, Rra^Esa, Rra^Esa, Gll, Gll, Gll, Rra^Esa, Rra^Esa, Aa, Rra^Edb, Chr^Edb, 1 Khr, Chr, Gd, Aa, Aa^Esa, Ms, Aa, Aa, Rra, Aa, Rra, Aa^Esa, Rra^Es, Aa^Esa, Aa, Md, Hh, Hh, Hh, Hh, Hh, Md, Md
Md, Md, Md, Md, Md, Md, Hh, Hh, Hh, Aa, Hh^Em, Rra, Rra, Rra^Esa, Hh, Aa, Mm^Xm, Aa^Esa, Chr^Edb, Chr, Ms, Aa, Aa, Ms, Hhd^Vhhr, Hh, Aa, Rra, Rra, Aa, Hhd^Em, Aa^Esa, Hhd^Dr, Md, Ha, Ha, Ha, Hhd, Ha, Hh, Hh, Md
Md, Md, Md, Md, Ms^Xm, Md, Md, Md, Md^Xm, Hhd^Em, Hhd^Dr, Hhd, Hh, Hh, Mm, Mm, Mm, Mm, Chr^Edb, Chr, Chr, Ms, Ms, Ms, Ha, Md, Hh, Hh, Hh, Hhd, Ha^Em, Hhd^Emf, Hhd^Em, Hhd^Em, Ha, Ha, Ms, Hhd, Hhd, Hh, Hhd^Dr, Hhd^Dr
Md, Md, Ms, Ms, Ms, Ms, Ms, Md, Md, Md, Md, Hhd^Em, Ms, Ms^Xm, Ms, Mm, Ms^Xm, Mm, Chr^Edb, 2 Khr, Chr, Ms, Md, Md, Md, Md, Md, Md, Md, Ha, Md^Xm, Ha^Em, Ha, Ha, Ms, Ms^Xm, Ms, Ms, Ms, Ms, Ms, Ms
Md, Ms, Ms, Ms, Ms, Ms, Mm, Ms, Ms, Md, Ms, Ms, Ms, Ms, Ms, Ms, Ms, Ms, Ms, Chr^Edb, Ms, Ms, Md, Md, Md, Md, Md, Md, Md, Md, Md, Md, Ms, Ms, Ms, Ms, Ms, Ms, Ms, Ms, Ms, Ms
