Wo, Wo, Wo, Wo, Wo, Wo, Wo, Wo, Wo, Wo, Wo, Wo, Wo, Wo, Wo, Wo, Wo, Wo, Wo, Wo, Wo, Wo, Wo, Wo, Wo, Wo, Wo, Wo, Wo, Wo, Wo, Wo, Wo, Wo, Wo, Wo, Wo, Wo, Wo, Wo
Wo, Wo, Wo, Wo, Wo, Wo, Ww, Wo, Wo, Wo, Wo, Wo, Ww, Ww, Ww, Wo, Ww, Wo, Wo, Wo, Wo, Wo, Wo, Wo, Wo, Wo, Wo, Wo, Wo, Wo, Wo, Wo, Wo, Wo, Wo, Wo, Wo, Wo, Wo, Wo
Wo, Wo, Wo, Wo, Ww, Ww, Wwr, Ww, Ww, Wo, Ww, Ww, Ds, Ds, Ds, Ww, Ds, Ww, Ww, Ww, Ww, Wo, Wo, Wo, Wo, Wo, Wo, Wo, Wo, Wo, Wo, Wo, Wo, Wo, Wo, Wo, Wo, Wo, Wo, Wo
Wo, Wo, Wo, Ww, Wwf, Wwr, Ds, Ds, Ds, Ww, Ds, Ww, Gs^Fms, Gs^Fms, Gs^Fds, Ds, Gs^Fms, Gs^Fms, Ds, Wwr, Wwr, Ww, Wo, Wo, Wo, Wo, Wo, Wo, Wo, Wo, Wo, Wo, Wo, Wo, Wo, Wo, Wo, Wo, Wo, Wo
Wo, Wo, Wo, Ww, Ds, Ds, Hh^Fms, Gs^Fds, Gg, Ds, Rr, Hh, Hh^Em, Gs^Fds, Gs^Fms, Gg^Efm, Gs^Fms, Gg, Gs^Efm, Ds, Ds, Ww, Wo, Wo, Wo, Wo, Wo, Wo, Wo, Wo, Ww, Wo, Wo, Wo, Wo, Wo, Wo, Wo, Wo, Wo
Wo, Wo, Wo, Ww, Ds, Hh^Fms, Chr, Chr, Chr, Gs^Fms, Rr, Chr, Hh^Em, Hh^Fds, Gs^Fms, Gg, Gg, Gs, Chr, Gg, Ds, Ww, Ww, Wo, Wo, Wo, Ww, Wo, Ww, Ww, Wwr, Ww, Ww, Ww, Wo, Wo, Wo, Wo, Wo, Wo
Wo, Wo, Wo, Ww, Hh, Hh, Chr, 2 Khr, Chr, Gs^Fms, Gs^Vh, Gg^Efm, Gg, Hh, Gg, Rr, Rr, Gd, Gs^Fms, Gs, Ds, Ww, Ww, Ww, Ww, Ww, Ww, Ww, Ds, Wwf, Ds, Wwr, Ww, Ww, Wo, Wo, Wo, Wo, Wo, Wo
Wo, Wo, Wo, Ww, Ds, Gg, Gg, Chr, Gs^Fms, Gs, Gg, Gg, Gd^Es, Gs^Es, Gs^Fms, Gs^Fms, Rr, Gs^Fms, Gd^Es, Gs^Fms, Wwr, Ww, Wwr, Ww, Wwr, Ww, Ds, Ds, Hh^Fms, Hh, Hh^Fms, Ds, Ds, Ww, Ww, Wo, Wo, Wo, Wo, Wo
Wo, Wo, Wo, Ww, Ww, Ds, Gs, Gs^Fms, Gs^Fds, Rr, Gs^Fms, Gs^Fds, Gs^Fms, Gs, Gg, Gg^Efm, Gg, Gs, Gs^Fms, Ds, Wwf, Wwr, Ds, Wwr, Ds, Ds, Gg^Fet, Gs^Fms, Chr, Chr, Chr, Gs^Fms, Ds, Wwr, Wwr, Ww, Ww, Wo, Wo, Wo
Wo, Wo, Wo, Wo, Ww, Ds, Gs^Fms, Gd^Es, Hh, Rr, Rr^Vhc, Gg, Aa, Gg^Efm, Gs^Fms, Gg, Hh^Em, Gg, Gs^Fms, Ds, Ds, Ds, Gd^Es, Ds, Gs, Gs^Fms, Gs^Fds, Gs^Fds, Chr, 3 Khr, Chr, Gs^Fms, Hh, Ds, Ds, Wwr, Ww, Wo, Wo, Wo
Wo, Wo, Wo, Wo, Ww, Ds, Gs^Fms, Gs, Gg, Hh^Em, Hh^Fds, Gg^Fet, Gg, Gg^Efm, Aa, Hh, Ww, Hh^Emf, Hh^Em, Gs^Fms, Gg, Gs, Gs^Vh, Gs, Gg^Efm, Gs^Fms, Rr, Hh^Fms, Rr, Chr, Hh, Hh^Em, Gs^Fds, Gs^Fms, Rr, Ds, Ww, Wo, Wo, Wo
Wo, Wo, Wo, Wo, Wo, Ww, Gs^Fms, Gs^Fds, Gg^Efm, Hh^Em, Hh, Gs^Fds, Gg, Gs^Fms, Aa, Hh^Em, Ds, Ww^Wkf, Hh^Em, Rr, Rr, Rr, Rr, Gg, Ww^Wkf, Gg^Efm, Chr, Rr^Vhc, Gg^Efm, Gg^Efm, Ww^Ewf, Gg, Gs^Fms, Chr, Rr, Ds, Ww, Wo, Wo, Wo
Wo, Wo, Wo, Wo, Wo, Ww, Ds, Gs^Fds, Gs^Fms, Gg, Gg, Chr, Gg^Efm, Aa, Gs^Efm, Gd^Es, Gs^Fms, Wwr, Gs^Fms, Ds, Ds, Ww, Ds, Wwr, Ww^Ewl, Gg, Gs, Gg, Hh, Ww^Ewl, Ds, Gg^Efm, Gg, Rr, Ds, Ds, Ww, Wo, Wo, Wo
Wo, Wo, Wo, Wo, Ww, Ww, Ww, Ds, Gs^Fms, Gs, Ww, Gg^Efm, Ds, Ds, Gg, Gd, Gs^Fms, Ww^Ewl, Ww^Ewf, Ww^Ewf, Ww, Gg, Gs, Ds, Ds, Wwf, Gs^Es, Gg, Ds, Ww, Ds, Gs^Es, Gs^Fms, Gs^Fds, Gs^Fms, Wwr, Ww, Ww, Wo, Wo
Wo, Wo, Wo, Wo, Wo, Ww, Ds, Ds, Rr, Rr, Ww^Ewf, Ds, Wwr, Ww^Ewl, Ww, Gs^Fms, Rr, Ds, Gg, Gg^Efm, Gg^Efm, Chr, Gd^Es, Ww, Hh^Em, Wwf, Wwf, Gd, Gs^Fms, Ds, Gg^Efm, Gg^Efm, Ds, Gs^Fms, Ds, Ww, Ww, Wo, Wo, Wo
Wo, Wo, Wo, Wo, Wo, Ww, Ds, Rr, Ww^Wkf, Ds, Ww^Ewl, Ds, Wwr, Ds, Ds, Rr, Ww, Rr, Gg, Gs^Fms, Gs^Fms, Gg, Gg, Gs^Es, Hh^Emf, Ds, Ds, Gg, Gg^Fet, Gs^Fds, Ds, Ds, Ww, Ds, Ww, Ww, Wo, Wo, Wo, Wo
Wo, Wo, Wo, Wo, Ww, Ww, Ds, Gs^Fms, Gg^Efm, Ds, Wwf, Ds, Gs^Fms, Gg^Efm, Ww^Ewl, Ww, Gs^Fms, Gs^Fms, Gg, Gs^Fds, Mm, Hh^Fms, Gs^Fms, Gg, Gg^Efm, Hh^Em, Hh, Gs, Gs^Fms, Ds, Wwf, Wwr, Wwr, Ww, Wo, Ww, Wo, Wo, Wo, Wo
Wo, Wo, Wo, Wo, Ww, Ww, Wwr, Gs^Fms, Ds, Gg, Gs^Fms, Wwf, Gs^Fms, Gg, Gg, Gs^Fms, Hh, Gs^Fms, Mm, Mm, Mm, Hh^Fds, Gs^Fds, Gs^Vh, Gg, Gs, Gs, Gd, Hh^Vhh, Ds, Ds, Wwr, Ww, Ww, Wo, Wo, Wo, Wo, Wo, Wo
Wo, Wo, Wo, Wo, Wo, Ww, Ww, Wwr, Wwr, Ds, Ds, Gs^Fms, Gs, Chr, Aa, Hh^Fms, Mm, Mm, Mm, Hhd^Fms, Hhd^Em, Mm, Mm, Gs^Fds, Rr, Rr, Rr, Aa, Hh, Hh^Em, Gs^Fms, Gs^Fms, Ds, Ww, Ww, Wo, Wo, Wo, Wo, Wo
Wo, Wo, Wo, Wo, Wo, Wo, Wo, Ww, Ww, Ww, Wwr, Ds, Ds, Gs, Hh, Hh, Hhd^Em, Mm, Mm, Mm, Mm, Mm, Mm, Gs^Fms, Hh, Hh, Chr, Aa, Aa, Gg, Gg^Efm, Gg, Gd, Gs^Fms, Gs^Fms, Ww, Ww, Wo, Wo, Wo
Wo, Wo, Wo, Wo, Wo, Wo, Wo, Wo, Ww, Ww, Wwr, Wwf, Ds, Gs^Vh, Hh^Fms, Hhd^Fms, Mm, Hhd^Emf, Hhd^Em, Mm, Mm, Mm, Hh^Fms, Mm, Hh, Chr, 4 Khr, Chr, Gs^Fms, Gs^Fms, Ds, Gs, Gs^Fms, Gs^Fms, Ds, Ds, Ww, Wo, Wo, Wo
Wo, Wo, Wo, Wo, Wo, Wo, Ww, Ww, Ww, Wwr, Wwf, Ds, Gg^Efm, Gs^Fms, Mm, Mm, Mm, Mm, Mm, Mm, Hh, Hh, Mm, Hh^Fds, Gs^Fms, Chr, Chr, Chr, Rr, Ds, Ww^Wkf, Ds, Rr, Ds, Wwr, Ww, Ww, Wo, Wo, Wo
Wo, Wo, Wo, Wo, Wo, Wo, Ww, Wwr, Ds, Wwr, Ds, Gs^Fms, Hh, Hh^Fms, Hh^Fms, Mm, Mm, Mm, Mm, Mm, Mm, Mm, Mm, Mm, Mm, Gs^Fds, Gs^Fds, Rr, Gs^Es, Gd, Wwr, Ds, Rr, Ds, Ds, Wwr, Ww, Wo, Wo, Wo
Wo, Wo, Wo, Wo, Wo, Ww, Wwr, Ds, Gg, Ds, Gs^Fms, Hh^Fms, Hh, Hh, Mm, Mm^Xm, Mm, Hh^Fms, Hh^Fms, Mm, Mm, Mm, Mm, Mm, Mm, Mm, Hh^Fms, Gs^Fms, Gs, Hh, Ww^Wkf, Rr, Ww, Gd, Gs, Ww, Ww, Wo, Wo, Wo
Wo, Wo, Wo, Wo, Wo, Ww, Ds, Hh, Gg^Efm, Gs^Fms, Gs, Gs^Fds, Hh, Gg^Fms, Hhd^Fms, Mm, Mm, Mm^Xm, Mm, Hh, Hhd^Em, Mm, Mm, Mm, Mm^Xm, Hh^Fms, Hh^Fms, Gs^Fms, Gg^Efm, Ds, Ds, Ww^Ewf, Ds, Gs^Fms, Gg^Efm, Ds, Ww, Ww, Wo, Wo
Wo, Wo, Wo, Wo, Ww, Ds, Hh, Hh, Chr, Rr, Rr, Gg^Efm, Gs, Gs, Mm, Mm, Mm, Mm, Mm, Mm, Mm, Hhd^Emf, Hhd^Em, Mm, Mm, Mm, Hh^Fms, Hh, Gg, Ww, Ds, Wwf, Gd, Ww, Gg^Efm, Ds, Ww, Ww, Wo, Wo
Wo, Wo, Wo, Ww, Ww, Ds, Hh, Chr, 1 Khr, Chr, Gs^Fms, Gs^Fds, Gd, Gs^Fms, Hh^Fms, Mm, Mm, Mm, Mm, Mm, Mm, Mm, Mm, Mm, Mm, Hhd, Hh, Gs^Fms, Chr, Wwr, Wwr, Gs^Vh, Gs^Fms, Gs, Gs^Fms, Gg, Ww, Ww, Wo, Wo
Wo, Wo, Wo, Wo, Ww, Ds, Hh, Chr, Chr, Chr, Gd^Es, Gs^Fms, Gs^Fms, Gs, Hh, Hh^Fms, Hh, Mm, Hh^Fms, Hh, Mm, Mm, Hhd, Hhd, Mm^Xm, Mm, Gg^Efm, Gs^Fms, Rr, Rr, Aa, Aa, Hh^Fms, Gs^Fms, Ds, Gs^Fds, Ww, Wo, Wo, Wo
Wo, Wo, Wo, Ww, Ww, Wwr, Ds, Rr, Rr, Rr, Gs, Gs, Gg, Gg, Rr, Hh^Em, Gg, Gg^Efm, Gg, Rr, Rr, Mm, Mm, Mm, Mm, Mm, Rr, Gg, Gs^Fms, Gs^Fms, Aa, Hh, Ds, Ds, Wwr, Ww, Wo, Wo, Wo, Wo
Wo, Wo, Wo, Wo, Ww, Ds, Gs^Fds, Gg, Gs^Fms, Gg, Gg^Efm, Gg^Efm, Gs^Fms, Rr, Gs^Fms, Rr, Gs, Gs^Vh, Hh^Em, Chr, Rr, Gs, Aa, Hh^Vhh, Hh, Rr, Chr, Rr, Hh, Hh^Fms, Hh^Emf, Hh^Em, Ds, Wwf, Wwr, Ww, Wo, Wo, Wo, Wo
Wo, Wo, Wo, Wo, Ww, Ds, Gd, Gs, Gs^Fds, Gs^Fms, Gs^Fms, Gg, Hh, Gs^Fms, Gs^Fms, Gs^Fms, Gs^Es, Gd^Es, Hh, Hh, Ww^Wkf, Gg, Gg^Efm, Hh, Aa, Gs^Fms, Gs^Fms, Gd, Gg, Hh^Em, Gg, Hh^Em, Hh^Fms, Ds, Ds, Ww, Wo, Wo, Wo, Wo
Wo, Wo, Ww, Ww, Ds, Ds, Gs, Gg, Gg^Efm, Gs^Fms, Gs^Vh, Gg, Hh^Fds, Hh, Rr, Gs, Wwf, Wwf, Wwr, Wwr, Ds, Gg^Efm, Gs^Fms, Gg^Efm, Aa, Gs^Fms, Gs, Gs^Es, Ds, Gs^Fms, Ds, Gg^Efm, Gd^Es, Gs, Gs^Fms, Ds, Ww, Wo, Wo, Wo
Wo, Wo, Ww, Wwr, Ds, Hh^Fms, Hh^Fds, Gg^Efm, Gg, Gs^Efm, Gg, Gg, Chr, Hh^Em, Rr, Ww^Ewl, Ds, Ds, Ww^Ewf, Ds, Ww, Wwf, Gs^Fms, Gs^Fds, Gs^Fds, Aa, Gg, Ds, Ww^Ewf, Ds, Ww^Wkf, Ds, Gs^Es, Gs^Fms, Ds, Ds, Ww, Wo, Wo, Wo
Wo, Wo, Wo, Ww, Ds, Hh^Fms, Gs^Fds, Gg, Hh^Fds, Hh, Hh^Fms, Gs^Fms, Gs^Fms, Rr, Ds, Ww, Ds, Hh, Ww^Ewl, Ds, Gg, Gs^Fms, Gd^Es, Gg^Fet, Gs^Fms, Gs^Fms, Ww, Ww^Ewl, Rr, Ww^Ewl, Ds, Ds, Rr, Gs^Fms, Gs^Fms, Wwr, Ww, Wo, Wo, Wo
Wo, Wo, Wo, Ww, Ww, Ds, Gg, Gg, Gs^Fms, Hh^Fds, Gs^Fms, Gg^Fet, Gg^Efm, Gd^Es, Ds, Ww^Wkf, Gg, Hh^Em, Hh, Ww^Ewl, Ds, Gs^Efm, Gs^Fms, Gd, Ds, Wwr, Ds, Rr, Wwr, Rr^Vhc, Ww^Ewl, Rr, Gg, Gg, Hh, Ds, Ww, Ww, Wo, Wo
Wo, Wo, Wo, Wo, Wo, Ds, Ds, Gs^Fms, Gg, Gg, Gs^Fms, Gg, Rr, Gs^Es, Gg^Efm, Ds, Gg^Efm, Gs^Fms, Hh, Wwr, Ds, Gg^Efm, Aa, Gs, Gg, Ds, Gs, Gd^Es, Gs^Fms, Ww, Gs^Fms, Gs^Fms, Hh^Em, Hh, Hh^Em, Ds, Ww, Ww, Wo, Wo
Wo, Wo, Wo, Wo, Wo, Ww, Wwf, Hh, Gs^Fms, Gg^Efm, Gg, Rr, Chr, Rr^Vhc, Rr, Gg^Efm, Hh^Fds, Hh^Fms, Gg, Ds, Gs^Fms, Gg, Hh, Hh^Fms, Gs^Fms, Gg^Efm, Aa, Gg, Rr, Gs^Fms, Gg^Fet, Hh^Fms, Hh, Ds, Ds, Ds, Ww, Wo, Wo, Wo
Wo, Wo, Wo, Wo, Wo, Ww, Wwr, Ds, Hh, Rr, Rr, Gd, Gg^Efm, Gs^Fds, Gg, Gs^Fms, Gs^Fms, Gg, Rr, Gs^Fms, Rr, Gg, Gg^Efm, Hh^Fms, Rr, Rr, Chr, Aa, Rr^Vhc, Gs^Fms, Hh, Hh, Ds, Wwf, Ww, Ww, Wo, Wo, Wo, Wo
Wo, Wo, Wo, Wo, Ww, Ww, Ds, Ds, Hh^Em, Chr, Hh, Gg, Gs, Gs^Fms, Hh, Gg, Ds, Ds, Ds, Rr, Ds, Ds, Ds, Gg, Rr, Chr, 5 Khr, Chr, Gs^Fds, Rr, Ds, Ds, Wwr, Wwr, Ww, Wo, Wo, Wo, Wo, Wo
Wo, Wo, Wo, Wo, Wo, Ww, Ww, Ds, Ds, Hh, Ds, Gg, Ds, Gd, Hh, Ds, Ww, Wwr, Ww, Ww, Ww, Wwr, Ww, Ds, Hh, Chr, Chr, Chr, Gs^Fds, Gs^Fds, Ds, Ww, Ww, Ww, Wo, Wo, Wo, Wo, Wo, Wo
Wo, Wo, Wo, Wo, Wo, Ww, Wo, Ww, Ww, Ds, Wwf, Ds, Wwr, Ds, Ww, Ww, Wo, Ww, Wo, Wo, Wo, Ww, Ww, Ds, Ds, Hh^Fms, Hh^Fms, Hh^Fms, Ds, Ds, Ww, Ww, Wo, Wo, Wo, Wo, Wo, Wo, Wo, Wo
Wo, Wo, Wo, Wo, Wo, Wo, Wo, Wo, Ww, Ww, Ww, Wwr, Ww, Ww, Wo, Wo, Wo, Wo, Wo, Wo, Wo, Wo, Wo, Ww, Ww, Ds, Ww, Ds, Ww, Ww, Ww, Ww, Wo, Wo, Wo, Wo, Wo, Wo, Wo, Wo
Wo, Wo, Wo, Wo, Wo, Wo, Wo, Wo, Wo, Wo, Wo, Ww, Wo, Wo, Wo, Wo, Wo, Wo, Wo, Wo, Wo, Wo, Wo, Wo, Wo, Ww, Wo, Ww, Wo, Wo, Wo, Wo, Wo, Wo, Wo, Wo, Wo, Wo, Wo, Wo
Wo, Wo, Wo, Wo, Wo, Wo, Wo, Wo, Wo, Wo, Wo, Wo, Wo, Wo, Wo, Wo, Wo, Wo, Wo, Wo, Wo, Wo, Wo, Wo, Wo, Wo, Wo, Wo, Wo, Wo, Wo, Wo, Wo, Wo, Wo, Wo, Wo, Wo, Wo, Wo
