Ds, Gs^Fds, Gd, Gg, Gg^Fms, Aa, Aa, Gg, Gs^Fdw, Hh^Fms, Hh, Hh, Hh^Fms, Hh, Mm, Hh^Fms, Mm, Mm^Xm, Mm, Hh, Gs, Gg, Gs^Fp, Gg, Ds, Wwf, Gs, Gg, Ww^Wkf, Ds, Gg, Gg, Aa, Gs, Gs, Mm, Mm, Hh, Hh, Hh
Wwr, Ds, Ds, Gs^Fds, Gs^Fms, Aa, Gg, Gg, Gs^Fms, Gd^Es, Gs^Fms, Gs^Fds, Hh^Fms, Mm, Mm, Mm, Mm, Mm, Hhd, Gs^Fp, Gg^Efm, Hh^Fp, Ds, Ds, Ww^Ewl, Wwf, Gd^Es, Gs^Fds, Wwf, Ds, Gd^Es, Gs^Fds, Gs, Gg, Ch, Gs^Fdw, Gg, Mm, Hh^Em, Hh^Em
Ww, Wwr, Wwr, Ds, Ds, Gs, Ch, Ch, Ch, Rr, Ch, Aa, Mm, Mm, Mm, Mm, Mm, Mm, Gd, Gs, Gg, Gs^Fp, Ds, Ww^Wkf, Gll^Es, Gg, Gg, Wwf, Gg^Efm, Gs, Ch, Ch, Rr, Ch, 2 Kh, Ch, Gg, Gs^Es, Hhd^Em, Hhd^Emf
Wo, Ww, Ww, Wwf, Ds, Gg, Ch, 4 Kh, Ch, Rr, Ch, Aa, Aa, Mm, Mm, Mm, Mm, Hhd^Fms, Gs^Fds, Gg, Gg^Fet, Ds, Ww, Wwr, Gll^Es, Hh^Fms, Hh^Fms, Gg, Gs, Gg, Gg, Ch^Dr, Rr, Ch, Ch, Ch, Gs^Fms, Gd^Fds, Mm^Xm, Hhd^Em
Wo, Wo, Ww, Wwr, Ds, Gg, Ch, Ch, Rr, Rr, Gg, Gg, Hh^Fds, Gd^Es, Gs, Mm, Hh^Fms, Hh^Fds, Gs, Gg, Gs^Fp, Ds, Wwf, Ch, Gs, Ds, Gs^Fds, Gs^Fds, Gd^Es, Gs^Vh, Gg, Gs^Fms, Rr^Vhc, Rr, Rr, Rr, Gs^Fms, Mm, Mm, Mm
Wo, Wo, Ww, Ww, Ds, Gs^Fms, Gs^Fms, Gs^Fms, Gs^Es, Rr^Vhc, Wwf, Gs^Fms, Ds, Hh^Fms, Gg, Hhd^Em, Gg, Gs^Fdw, Gs^Fms, Gg, Gs, Ds, Wwf, Wwf, Aa, Gg, Aa, Aa, Gg, Gs, Wwf, Gg, Gs^Fds, Ch, Ch, Ch^Dr, Gg, Gd, Gs^Fdw, Hh
Wo, Wo, Wo, Ww, Wwr, Ds, Ds, Ds, Ds, Gd^Es, Ww^Ewl, Ds, Wwf, Ds, Ds, Gg, Wwr, Ds, Ds, Gg, Gd^Vh, Ds, Ds, Wwf, Wwr, Aa, Wwr, Aa, Gg^Efm, Wwf, Ds, Wwf, Wwf, Gs, Gg, Gg^Efm, Gg, Rr^Vhc, Gg, Gs^Fms
Wo, Wo, Wo, Ww, Ww, Wwr, Wwr, Wwf, Ds, Gs^Fms, Gg, Ww^Wkf, Ds, Wwf, Ds, Gg, Gd^Es, Wwf, Gg, Gg, Gg, Gs, Gg, Ds, Ds, Wwr, Ds, Aa, Gg^Efm, Ds, Wwf, Ds, Gg, Gg, Hh^Fms, Rr^Vhc, Gs, Gg, Ds, Gs^Fms
Wo, Wo, Wo, Wo, Wo, Ww, Ww, Wwr, Ww, Ds, Ds, Ds, Gs, Wwr, Wwr, Gs^Fms, Gs^Es, Gg, Mm, Hh, Hhd^Fms, Gg, Hhd, Gs, Aa, Ww^Ewf, Ds, Gs^Fdw, Gs^Fdw, Gg, Gd^Es, Gs^Es, Ds, Ds, Ds, Gs^Fds, Ds, Ds, Wwr, Ds
Wo, Wo, Wo, Wo, Wo, Wo, Wo, Ww, Ww, Wwr, Wwr, Ds, Gd, Rr^Vhc, Gg, Gg, Mm, Hhd^Em, Hhd^Fms, Mm, Mm, Gs^Fds, Gg, Gd^Es, Gll^Fdw, Ww^Wkf, Wwf, Ds, Gd^Fmw, Gg, Ds, Ds, Ww, Wwf, Wwf, Ds, Ww^Wkf, Wwf, Gll^Es, Wwr
Wo, Wo, Wo, Wo, Wo, Wo, Wo, Ww, Ww, Ww, Ds, Ds, Gd^Fms, Gg^Efm, Gs^Fms, Mm, Mm, Mm, Mm, Mm, Mm, Gd^Fms, Gd^Es, Gg, Gg, Gll^Fmw, Wwf, Ds, Gs, Gg, Ds, Wwr, Gll^Fmw, Gll, Wwf, Ds, Ww^Ewl, Gll^Es, Gg^Efm, Gll
Wo, Wo, Wo, Wo, Wo, Wo, Wo, Ww, Ww, Ds, Gs, Gs^Fms, Ww^Wkf, Gg, Gs^Fds, Hh^Fms, Mm^Xm, Mm, Mm, Mm, Hhd^Fds, Mm, Hh, Gg, Ds, Gg, Ds, Ds, Ds, Ds, Wwf, Ww, Gll^Fdw, Gg, Aa, Ww, Aa, Aa, Aa, Gg
Wo, Wo, Wo, Wo, Wo, Wo, Wo, Ww, Ww, Ds, Ds, Gg, Wwf, Ds, Gs^Fds, Mm, Mm, Mm, Hhd^Emf, Hh^Fds, Gd, Hhd^Em, Gs^Fdw, Gg^Efm, Ch, Ds, Wwf, Wwf, Ww^Ewl, Ww^Wkf, Gg, Gll, Gg^Efm, Gg, Gd, Aa, Gs^Fdf, Gs, Gd, Gg
Wo, Wo, Wo, Wo, Wo, Wo, Wo, Ww, Ww, Ww, Ds, Gg, Gs, Gs, Gg, Gs^Fms, Gd^Fms, Hhd^Em, Gs, Gs^Fms, Gs, Gs^Fdw, Wwf, Gg^Efm, Ds, Ds, Wwf, Wwf, Aa, Aa, Ch, Rr, Ch, Gg, Hh, Gs^Fdf, Hhd^Fdw, Hh^Fdf, Gs, Gd^Fdf
Wo, Wo, Wo, Wo, Wo, Wo, Wo, Ww, Ww, Ds, Wwr, Ds, Ds, Gg, Gs^Vh, Gg^Efm, Gg, Gs, Hh, Gg, Gs^Fms, Gs^Vh, Wwf, Gg, Ds, Wwr, Ww, Gll, Gg, Ch, 3 Kh, Rr, Rr, Gs, Mm, Mm^Xm, Mm, Hhd, Aa, Gs^Fdf
Wo, Wo, Wo, Wo, Wo, Wo, Wo, Ww, Wwr, Wwr, Wwf, Wwf, Ds, Hh, Gd, Gg, Gll, Hh, Wwr, Hhd, Hhd^Fms, Wwf, Gg, Gs, Ds, Wwr, Ww, Gll^Fdw, Gll, Ch, Ch, Ch, Gs^Fdf, Gd^Fdf, Hh^Fdf, Mm, Mm, Hh^Fdf, Hhd^Em, Aa
Wo, Wo, Wo, Wo, Wo, Wo, Ww, Ww, Ww, Wwr, Ds, Ds, Hhd, Hh^Fdf, Gg, Gll^Es, Wwf, Wwr, Gg, Gs^Fms, Ww^Wkf, Aa, Gg^Efm, Gs^Fdw, Gd^Es, Ds, Ds, Wwf, Rr^Vhc, Gg, Gs, Aa, Aa, Hhd, Gs^Fdw, Hh, Hhd, Mm, Mm, Hh
Wo, Wo, Wo, Wo, Wo, Wo, Ww, Ds, Ds, Ds, Hh^Fdf, Gg, Gg^Efm, Gg, Gs^Fms, Gll^Es, Wwf, Hhd, Wwf, Gs^Fms, Aa, Aa, Gs^Efm, Gg^Efm, Gg, Gs^Fds, Ds, Wwr, Wwr, Gg, Gd^Es, Aa, Gs, Gs^Fdf, Gs, Gd, Gs^Fdw, Gs^Fdf, Gs^Fdf, Hh
Wo, Wo, Wo, Wo, Wo, Wo, Ww, Wwr, Ds, Hhd, Hh, Gg^Efm, Gd^Es, Gs^Fds, Ds, Wwf, Ds, Wwf, Wwf, Ch, Gd, Gs^Vl, Wwf, Wwr, Wwr, Gg, Gg^Efm, Ds, Ds, Wwf, Ww^Wkf, Gs^Es, Gg, Gg, Aa, Hh^Em, Mm, Hhd^Emf, Hh^Em, Gs
Wo, Wo, Wo, Wo, Wo, Ww, Ww, Ds, Gs, Gd, Chr, Gg, Gg, Ds, Gs^Fms, Ds, Wwf, Wwf, Wwr, Aa, Gg, Gll, Ww^Ewl, Ds, Gs, Gd^Es, Hh^Em, Gg, Gd^Es, Ds, Ds, Wwf, Wwf, Aa, Aa, Hhd, Mm, Mm, Mm, Hhd
Wo, Wo, Wo, Wo, Wo, Ww, Wwr, Ds, Gg, Chr, 1 Khr, Chr, Gs, Gs^Fdw, Wwf, Wwf, Aa, Gs^Fdw, Gg, Gg, Gd^Es, Gll^Es, Gll, Gg, Hhd^Em, Hhd^Fms, Hhd^Emf, Aa, Aa, Gs^Fms, Ds, Wwr, Ds, Wwf, Ww^Wkf, Mm, Mm, Mm, Mm, Hhd^Fdf
Wo, Wo, Wo, Wo, Ww, Ww, Wwr, Ds, Gg, Chr, Chr, Chr, Gd, Ww^Ewl, Gs^Vh, Wwr, Aa, Gd, Gg, Gs^Fdw, Aa, Aa, Mm, Mm, Mm, Mm, Mm, Hh^Em, Aa, Gg, Gg^Efm, Ds, Hh, Aa, Wwr, Gll, Hhd^Fdf, Mm, Mm, Mm
Wo, Wo, Ww, Ww, Wwf, Wwr, Ds, Ds, Gs^Fds, Chr, Gs^Fms, Chr, Gs^Fms, Gd, Gg^Efm, Wwr, Gs, Gs, Gg, Gs^Fdf, Aa, Gs, Hhd, Mm, Mm, Mm, Mm, Mm, Mm, Gs^Fms, Gg, Hh, Hhd, Aa, Aa, Wwr, Gg, Hhd^Fdf, Hhd, Hh^Fdw
Ww, Ww, Wwr, Wwr, Ds, Ds, Gg, Gg, Gg, Gs^Fds, Gs, Gd, Gs, Gg, Gg, Gg, Gs^Fms, Gs^Fds, Gs^Fms, Gg, Gg, Gs, Hh, Hhd, Hh, Mm, Mm, Mm, Hh, Gs^Fms, Gg, Gd^Es, Gs, Gg, Aa, Ww^Ewl, Gg, Gd^Fdw, Hh, Hh^Fdf
