Ds, Gs, Gs, Gg, Gg, Rr, Rr, Gs, Gs, Gs, Gs, Ds, Gs, Ds, Ds, Gs, Gs, Gs, Gs, Gs, Gs, Gs, Gs, Gs, Gs, Gs, Gs, Gs, Gs, Gs, Gd, Gg, Gg, Gg, Gs, Gg, Gg, Gg, Gg, Gg, Gs, Gs, Re, Ww, Ww, Ds, Ds, Gs, Gg, Gd^Fdf
Wwr, Ds, Ds, Gg, Gg, Gg, Rr^Vhc, Rr, Rr, Ch, Ch, Gs, Re, Gs, Gs, Gs, Gs, Gs, Gs, Ds, Gs, Gs, Gs, Gs, Gs, Gs, Gs, Gs, Gd, Gd, Ds, Gd, Gs^Fdw, Gs, Ds, Ds, Ds, Gg, Gg, Ch, Rr, Ch, Rr, Rr, Rr, Ww, Ww, Ds, Gg, Gd^Fdf
Ww, Wwr, Wwr, Ds, Gs, Gg, Gs, Gs, Ch, Rr, Re, Re, Gg, Re, Rr^Vhc, Re, Re, Gs, Gs, Ds, Gs^Fdw, Ds, Gs, Gs, Gs, Gs, Gs, Gs, Re, Re, Re, Gs^Fdw, Gs^Fdw, Gs^Fdw, Gs^Fdw, Gs^Fdw, Gs^Fdw, Ds, Ch, Rr, Rr^Vhc, Rr, Ch, Ch, Ch, Rr, Ww, Ds, Gs, Aa^Fpa
Wo, Ww, Ww, Ww, Ww, Gs, Gs, Ch, 4 Kh, Rr^Vhc, Gs, Gg, Gg, Gg, Gg, Gs, Gs, Re, Gs, Ds, Ds, Gs^Fdw, Gs^Vh, Gs, Gs^Fdw, Gs, Gs, Gs, Gs, Gs^Vl, Gs, Gs, Gs, Gd^Fdf, Gs, Gs, Gs, Gs, Ch, Rr, Rr, Rr, Ch, 2 Kh, Ch, Rr, Ww, Ds, Gs, Gs
Wo, Wo, Ww, Ww, Ww, Ww^Bw/r, Gs, Ch, Ch, Ch, Gs, Gg, Gg, Gg, Gg, Gg, Gs, Re, Re, Gs, Ds, Gs^Fdw, Gs, Gs^Fdw, Gs, Gs^Fdw, Gs, Gs, Gs, Gs, Gs, Gs, Gs, Gs, Gs, Gs, Gs, Gs, Re, Rr, Ww, Rr^Vhc, Rr, Ch, Rr, Rr, Ww, Ds, Gs, Aa^Fpa
Wo, Wo, Wo, Ww, Ww, Ww, Ds, Gs, Gs, Gs, Gg, Gg, Gg, Gg, Gg, Gg, Gg, Gs, Re, Gs, Gs, Gs, Re, Re, Re, Gs, Gs, Gs, Gs, Gs, Ds, Ds, Ds, Gs, Gs, Rr, Rr, Rr^Vhc, Wwr, Ww, Ds, Ww, Ww, Rr, Ww, Ww, Gs, Gs, Gd^Fdf, Aa^Fpa
Wo, Wo, Wo, Wo, Ww, Ww, Wwr, Ds, Ds, Gs, Gs, Gg, Gg, Gg, Gg, Gg, Gg, Gg, Re, Gs, Re, Re, Gs^Fdw, Gs^Fdw, Gs^Fdw, Re, Re, Gs, Re, Gs, Re, Wwr, Ww, Ds, Ds, Ds, Ww, Ww, Ds, Ds, Gs, Ds, Ds, Ww, Ds, Ds, Gs^Fdw, Gg, Gg, Gs
Wo, Wo, Wo, Wo, Ww, Wwr, Ds, Ds, Gs, Ds, Gs, Gg, Gg, Gg, Gg, Gg, Gg, Gg, Gg, Rr^Vhc, Gg, Gs^Fdw, Gs, Gd^Fdw, Gs^Fdw, Gg, Gg, Re, Gg, Re, Rr^Vhc, Ww, Wo^Bw/r, Wwr, Ww, Ww, Gs, Ds, Gs, Gg, Gd^Fdw, Gs, Gs, Ds, Gs, Gg, Gd, Gd, Gs^Fdw, Gs^Fdw
Wo, Wo, Wo, Wo, Ww, Wwr, Wwr, Ds, Ds, Gs, Gg, Gg, Ds, Gg, Gs^Vl, Gs, Gs, Gg, Gg, Gg, Gg, Gs, Gd^Fdw, Ds, Re, Gg, Gg, Gg, Gg, Gg, Re, Wo^Bw/r, Ww, Wwr, Ds, Gs, Gg, Gg, Gd^Fdw, Gd, Gs^Fdw, Aa, Gs, Gs, Gs^Fdw, Gs^Fdw, Gd, Gs^Fdw, Gd^Fdf, Gd^Fdf
Wo, Wo, Wo, Wo, Wo, Ww, Ww, Wwr, Wwr, Ds, Gg, Gg, Ds, Gs^Fdw, Gs^Fdw, Gs^Fdw, Gs, Gs, Gg, Gg, Ds, Gs, Ds, Ds, Re, Gg, Gg, Gg, Gg, Gg, Gg, Re, Ds, Ww, Ds, Gs^Fdw, Gg, Gd^Fdw, Aa, Gd^Fdw, Aa, Aa, Gs, Gs^Fdw, Gd^Fdf, Gd^Fdf, Gg^Ve, Gs^Fdw, Gs^Fdw, Gs^Fdw
Wo, Wo, Wo, Wo, Wo, Wo, Ww, Ww, Wwr, Ds, Ds, Gg, Gg, Ds, Gd^Fdw, Gd^Fdf, Gs, Gs, Gg, Ds, Gg, Ds, Gg, Re, Gg, Gg, Gg, Gg, Ds, Gg, Gs, Gs, Ds, Ww, Ds, Gd^Fdw, Gs, Gs, Gs^Fdw, Aa, Gd, Gs, Gg, Gs^Fdw, Gd^Fdf, Aa^Fpa, Gd^Fdf, Gd^Fdf, Gd^Fdf, Gd^Fdf
Wo, Wo, Wo, Wo, Wo, Wo, Ww, Ww, Ww, Wwr, Ds, Gs, Gs, Ds, Ds, Gd^Fdw, Gg, Gg, Gd, Gg, Gg, Gg, Gg, Gg, Gg, Gg, Gs, Gg, Ds, Gs, Re, Ds, Ww, Ww, Ds, Gs, Aa, Gs, Gs, Gs, Gs, Aa, Gs^Fdw, Gg, Gs, Aa^Fpa, Aa^Fpa, Gd^Fdf, Aa^Fpa, Gd^Fdf
Wo, Wo, Wo, Wo, Wo, Ww, Ww, Ww, Wo, Ww, Ww, Ds, Ds, Gs, Gg, Ds, Gs, Gg, Ds, Ds, Gg, Gg, Gs, Gs, Gs^Vl, Gs, Ds, Ds, Gs, Gs, Re, Ww, Ds, Ds, Gs, Gd, Gs^Fdw, Aa, Gs, Gs, Aa, Aa, Aa, Gs^Fdw, Gs^Fdw, Gs, Gs, Aa^Fpa, Aa^Fpa, Gd^Fdf
Wo, Wo, Wo, Wo, Wo, Ww, Wo, Ww, Ww, Ww, Ww, Ww, Ww, Ds, Gg, Gg, Gs, Ds, Gs, Gs, Gg, Gg, Gg, Gs, Gs, Gs, Ds, Gs, Re, Re, Ww, Ww, Ds, Gg, Gd, Gd^Fdw, Aa, Aa, Gd, Gs, Gs, Gd, Gd, Aa, Gd^Fdw, Gg, Gg, Gg^Ve, Aa^Fpa, Aa^Fpa
Wo, Wo, Wo, Wo, Wo, Wo, Wo, Wo, Wo, Wo, Ww, Ww, Ww^Bw\r, Gs, Gg, Gg, Gg, Gd, Gs^Vh, Gg, Gg, Gg, Gg, Gs, Gg, Ds, Gs, Re, Wwr, Wwr, Wwr, Ds, Gs, Gs^Fdw, Gd, Gs^Fdw, Gg^Ve, Aa, Gg, Gd, Hhd, Gd^Fdw, Gg, Gd^Fdw, Gg, Gg, Gd, Gs, Gs, Aa^Fpa
Wo, Wo, Wo, Wo, Wo, Wo, Wo, Wo, Wo, Wo, Ww, Ww, Ww, Gs, Gs^Fdw, Gg, Gg, Gs^Fdw, Gs^Fdw, Gg, Gs^Fdw, Gd, Gd, Gg, Gg, Ds, Gs, Re, Ds, Ww, Wo^Bw/r, Wwr, Ww, Gs, Gg, Gs^Fdw, Gg, Gg, Gs, Gd, Hh^Fdw, Hhd, Hhd, Hh, Hh, Md, Md, Gd, Mm, Gs
Wo, Wo, Wo, Wo, Wo, Wo, Wo, Wo, Ww, Ww, Ww, Ww^Bw\r, Gs, Gs, Ds, Gs^Fdw, Gd, Gs^Fdw, Gd, Gg, Gs^Fdw, Gs^Fdw, Gd, Gg, Gg, Gg, Gg, Gs, Ds, Wo^Bw/r, Ww, Ww, Gs, Ww, Ww, Gs, Gs, Gs, Hhd, Hh, Hhd^Fdw, Hhd, Md, Hh^Fpa, Hh^Fpa, Hh, Hh, Md, Hh^Fpa, Hh
Wo, Wo, Wo, Wo, Wo, Wo, Ww, Ww, Wwr, Ww, Ww, Ww, Gs, Gd, Ds, Gd^Fdw, Gs^Fdw, Gs^Fdw, Gd, Gg, Gg, Gg, Gg, Gg, Ds, Gg, Gg, Gs, Gs, Ds, Rr, Gs, Ch, Gs, Gs, Wwr, Ds, Gs^Fdw, Mm^Xm, Mm, Hhd, Md, Md, Md, Hh, Hhd, Mm, Hh, Mm^Xm, Hh^Fpa
Wo, Wo, Wo, Wo, Wo, Wo, Ww, Ww, Wwr, Ds, Ds, Ds, Gs, Ds, Gg, Gs^Fdw, Gd, Gd, Gs, Gg, Gg, Gg, Gg, Gs, Gs, Ds, Ds, Ds, Gg, Ch, Rr, Ch, 3 Kh, Ch, Gs, Wwr, Ds, Gs, Ds, Mm^Xm, Gs, Hh^Fdw, Hh^Fdw, Hh, Mm, Hhd, Hhd^Fpa, Mm^Xm, Mm, Mm
Wo, Wo, Wo, Wo, Wo, Wo, Wo, Ww, Ww, Wwr, Ds, Gs, Gg, Gg, Gg, Gg, Gg, Gs, Gg, Gg, Rr, Gg, Rr, Rr, Re, Gg, Gg, Gg, Rr^Vhc, Ch, Ch, Rr, Rr, Ch, Rr, Ww, Ww, Ds, Ww, Ds, Gs, Gg, Gg, Mm^Xm, Gd, Hhd, Mm, Mm, Mm, Mm
Wo, Wo, Wo, Wo, Wo, Wo, Ww, Ww, Ww, Wwr, Ds, Ds, Gg, Gs^Vh, Gs, Gg, Gg, Gs^Fdw, Gs^Fdw, Gd^Fdw, Re, Rr, Gs, Gs, Gs, Re, Re, Rr, Re, Rr, Rr, Ch, Re, Rr, Gs, Rr^Vhc, Rr, Ww, Rr^Vhc, Ww, Ww, Ds, Ds, Gg, Gd, Hh^Fdw, Mm, Mm, Hhd, Hh
Wo, Wo, Wo, Wo, Wo, Wo, Ww, Wo, Ww, Wwr, Wwr, Ds, Gs, Gs, Chr, Gs, Rr, Gg, Rr, Re, Gs, Gs, Gs, Gs, Gs, Gs, Gs, Re, Gs, Re, Re, Re, Gs, Gs, Gs, Rr, Gs, Rr, Re, Wwr, Re, Ww, Ww, Ds, Gs, Hh^Fdw, Hh, Hhd, Ww, Ww
Wo, Wo, Wo, Wo, Wo, Wo, Wo, Ww, Ww, Ww, Wwr, Ds, Gs, Chr, 1 Khr, Chr, Rr, Rr, Gs, Rr, Gs, Gs, Gs, Gs, Gs, Gs, Gs, Gs, Gs, Gs, Gs, Gs, Gs, Gs, Gs, Gs, Gs, Gs, Gs, Re, Gs, Re, Ww, Ds, Gs, Gg, Ww, Ww, Ds, Ds
Wo, Wo, Wo, Wo, Wo, Wo, Wo, Wo, Ww, Wwr, Ds, Ds, Gs, Chr, Chr, Chr, Rr, Gs, Gg, Gs, Gs, Gs, Gs^Fdw, Gs^Fdw, Ds, Gs, Ds, Ds, Ds, Gs, Ds, Gs, Gs, Gs, Gs, Gs, Gs, Gs, Gs, Gs, Gs, Re, Ww, Ds, Ww, Ww, Re, Ds, Gs, Gd^Fdw
Wo, Wo, Wo, Wo, Wo, Wo, Wo, Wo, Ww, Wwr, Wwr, Ds, Ds, Gs, Chr, Chr, Gs, Gg, Gg, Gs^Vc, Gs, Gs^Fdw, Ds, Ds, Gs, Ds, Gs, Gd, Gs, Ds, Gs, Ds, Ds, Gs, Gs, Gs, Gs, Gs, Gs, Gs^Vh, Gs, Ds, Ww, Ww, Ds, Re, Gs^Fdw, Gs, Mm^Xm, Gd
Wo, Wo, Wo, Wo, Wo, Wo, Wo, Ww, Ww, Ww, Ww, Wwr, Ds, Gs, Gs, Gs, Gs^Vh, Gg, Gg, Gg, Gs, Gd^Fdw, Ds, Gs, Gg, Gs, Gg, Gs^Vc, Gg, Gs, Gd^Fdf, Gs, Gs, Gs, Gs, Gs, Gs, Gs, Gs, Gd, Gs, Ds, Ds, Ww, Ww, Ds, Gs, Hhd^Fdw, Hh^Fdw, Hh
Wo, Wo, Wo, Wo, Wo, Wo, Wo, Wo, Wo, Ww, Ww, Wwr, Wwr, Ds, Gg, Gg, Gs, Gg, Gg, Gd, Ds, Ds, Gs, Gg, Gg, Gg, Gg, Gg, Gd, Gd^Fdf, Gd, Gd^Fdf, Gd^Fdf, Gs, Gd, Gs, Gs, Gs, Gs, Gd, Gd, Gs, Gs, Rr, Ww, Ds, Gg, Gd, Gd, Hhd^Fdw
Wo, Wo, Wo, Wo, Wo, Wo, Wo, Wo, Wo, Wo, Wo, Ww, Wwr, Ds, Ds, Ds, Gs, Gg, Gg, Gd, Ds, Gs, Gg, Gg, Gg, Gg, Gg, Gg, Gg, Gg, Gg, Gd, Gd, Gd, Gs, Gs, Gs, Gs, Gs, Gs, Gs, Gd, Gs, Rr, Ww, Ds, Gs, Mm, Mm, Mm
