Gs^Fds, Gs^Fds, Aa, Hh^Fmw, Hh^Fds, Gg, Gs^Fmw, Gs^Fmw, Wwr, Gs^Fms, Hhd^Fmw, Hhd, Hhd^Fp, Hhd, Hhd^Em, Hhd^Fp, Hhd^Fms, Mm, Mm, Hhd^Fdw, Hh^Fdw, Ss, Ss, Ss, Sm, Ss, Ss, Ss, Wwf, Ww, Wwr, Gg, Gg, Gg, Hh^Fmw, Hh^Fms, Hh^Fms, Gg
Gg, Gs^Fms, Aa, Hh^Fmw, Re, Gg^Fet, Gs^Fms, Wwr, Ww^Wkf, Gs^Fds, Hhd^Em, Mm, Mm, Mm, Mm, Hhd^Fp, Hhd^Em, Mm, Mm, Mm, Hh^Fdw, Ss, Sm, Sm, Aa, Sm, Sm, Ww^Wkf, Wwr, Gg^Efm, Gs, Gg^Efm, Ce, Hh, Aa, Aa, Gs^Fms, Aa
Gs^Fms, Aa, Ce, Ce, Ce, Re, Gs^Fds, Ww, Gs^Fds, Hh^Fds, Aa, Hhd^Fmw, Hhd^Fms, Mm, Mm, Mm, Mm, Mm, Mm, Mm, Hh, Wwf, Sm, Aa, Hhd, Aa, Aa, Hh, Hh^Fmw, Gg, Gs, Ce, 3 Ke, Ce, Gs, Aa, Aa, Gs^Fms
Hh^Fmw, Aa, Ce, 2 Ke, Ce, Gs^Fds, Re, Wwf, Gs^Fds, Aa, Gs^Fms, Aa, Mm, Mm, Mm, Mm, Mm, Mm, Mm, Mm, Hh^Em, Ww^Wkf, Hhd^Fms, Hhd^Fmw, Mm, Hhd^Fdw, Hhd^Em, Hh^Fms, Gs, Gg^Efm, Gs, Ce, Ce, Ce, Re^Es, Gs, Gs, Gs
Hh^Fds, Aa, Gs^Fdw, Ce, Gg^Efm, Wwf, Gs^Fms, Re^Es, Re^Es, Re, Re, Aa, Hh, Mm, Mm, Mm, Mm, Mm, Mm, Hhd^Fms, Hhd^Em, Hhd^Fms, Mm, Mm, Mm, Mm, Hhd^Vhhr, Gs^Es, Hh^Fmw, Gg^Efm, Gg^Efm, Gs, Gs, Re^Es, Gs^Fms, Gs^Ve, Re^Es, Gs^Fms
Re, Hh^Fds, Hh^Fmw, Gs^Fmw, Gs^Fdw, Wwf, Wwf, Gs^Ve, Aa, Gs^Fmw, Gs^Fds, Hh, Mm, Mm^Xm, Mm, Mm, Mm, Mm, Mm, Mm, Mm, Mm, Mm, Mm, Mm, Mm, Hh^Fms, Gs^Es, Hh, Hh^Fmw, Ss, Aa, Aa, Aa, Aa, Gs^Fms, Gs^Fms, Re
Gs^Fmw, Re, Re, Re^Es, Re^Es, Ww^Wkf, Wwr, Hh^Fms, Gg^Efm, Gs, Gg^Efm, Hh^Fds, Hh^Fdw, Mm, Mm, Mm, Mm, Mm, Hh^Fmw, Mm, Mm, Mm, Aa, Hh^Fdw, Hh^Fmw, Hhd, Gg^Efm, Gg, Wwf, Ss, Sm, Wwf, Hh^Fdw, Hh, Hh^Fms, Aa, Aa, Gs^Fms
Gs^Fmw, Gs^Fms, Aa, Gs^Ve, Re^Es, Gs^Fds, Wwf, Ww, Gg, Gs^Fmw, Gs^Fmw, Aa, Hh, Mm, Mm, Mm, Mm, Mm^Xm, Mm, Hh^Fdw, Hh, Aa, Hh, Gg^Efm, Wwf, Gs^Fds, Gs^Fds, Gs^Fds, Wwr, Ss, Sm, Sm, Hhd, Hh^Fmw, Mm, Hh, Hh, Gs^Fds
Hhd, Hhd, Aa, Hh^Fmw, Gs^Fms, Gs^Fds, Hh^Fds, Hh^Fds, Gs^Fms, Gs, Gs^Fdw, Aa, Aa, Hh, Hh^Fdw, Hh^Fmw, Mm, Mm, Hh, Hh^Fmw, Aa, Aa, Hh, Wwf, Wwf, Wwf, Ww^Wkf, Gs^Fds, Ww^Wkf, Ss, Ss, Hh, Mm, Mm, Mm, Hh^Fms, Hh^Fms, Hh
Hhd, Hh^Fdw, Aa, Hh^Fmw, Gg^Efm, Gg^Efm, Gs^Fmw, Hh^Fms, Wwf, Gs^Es, Hh^Fmw, Gs^Fdw, Gg, Aa, Aa, Mm, Mm, Mm, Mm, Hh, Hh^Fdw, Hh, Ww, Wwr, Hh, Wwr, Hh, Aa, Gg^Fet, Wwf, Wwf, Hh^Fdw, Mm, Mm, Mm, Mm, Hhd^Fds, Hh
Hhd, Hh, Hh, Aa, Aa, Gs^Fds, Gg^Efm, Ww, Ww^Wkf, Gg^Efm, Hh^Fds, Hh^Fds, Wwf, Wwf, Gs^Fds, Mm, Mm, Mm, Mm, Mm, Hh^Fdw, Gs, Gs, Hh^Fmw, Ww^Wkf, Wwr, Hh^Fmw, Aa, Gg^Efm, Gg, Hh, Mm, Mm, Mm, Hh^Fdw, Hhd^Em, Hhd^Emf, Hh^Fms
Hh, Hh, Hh, Hh^Fdw, Hh^Fmw, Aa, Aa, Gs^Ve, Gs^Es, Ww^Wkf, Wwr, Ww, Gs^Fms, Wwf, Wwf, Gs^Fds, Gs^Fms, Mm, Hhd^Fp, Hhd^Fmw, Hh, Aa, Gg^Efm, Ww^Wkf, Hh^Fds, Hh^Fds, Gs, Gg^Efm, Gs^Ve, Gs^Fds, Hh^Fms, Hh^Fdw, Hh^Fdw, Hh^Fdw, Hh, Hh^Em, Hhd^Fms, Hhd^Em
Hh^Fdw, Hh^Fdw, Hh^Fmw, Hh^Em, Hhd^Emf, Hh^Em, Hh^Fmw, Gs^Fms, Gs^Es, Wwr, Hh^Fds, Gs^Fds, Wwf, Gs^Fms, Hh^Fdw, Hh^Fmw, Aa, Aa, Aa, Hh, Aa, Hh, Gg^Efm, Ww, Hh, Gg, Gs, Gs^Fds, Gs^Fdw, Gs^Fmw, Hh, Hh, Mm, Hh^Fmw, Mm, Mm, Mm, Hhd^Em
Hh, Hh^Fds, Hhd^Fds, Hhd^Em, Mm, Hh^Em, Hh^Fdw, Gs^Fms, Gs^Fdw, Gg, Hh^Fds, Ww^Wkf, Gs^Fdw, Gg, Hh^Fds, Gs, Wwf, Gs^Fds, Gs^Fds, Aa, Gs^Ve, Gg^Efm, Gs^Fms, Hh, Gs^Fms, Gg^Efm, Ww, Wwr, Ss, Aa, Mm, Mm, Mm, Mm, Mm, Mm, Hh^Fmw, Hh^Fdw
Hhd, Hh^Fdw, Mm, Mm, Mm, Mm, Hh, Gs^Fmw, Gs^Fmw, Gg, Gg^Efm, Wwr, Wwf, Wwf, Gg, Gg, Gs^Fds, Wwf, Wwf, Gs^Fms, Gg, Gg, Gs^Es, Gs^Fms, Hh^Fmw, Gg, Gs, Gs^Es, Ss, Aa, Hh, Hh^Fmw, Hh^Fdw, Mm, Mm, Mm, Hh^Em, Hh^Fdw
Hhd, Mm, Mm, Mm, Mm, Mm, Mm, Aa, Hh^Fdw, Gs^Fds, Gg, Gg, Wwf, Gs^Fmw, Gg^Efm, Gs^Efm, Hh^Fms, Hh^Fms, Gg^Es, Gg^Es, Gs^Fms, Gs, Ww^Wkf, Wwr, Wwf, Hh^Fds, Gg, Gs^Es, Hh, Aa, Aa, Hhd, Hh, Mm, Hh^Fmw, Hh^Fdw, Hh^Em, Hh^Emf
Hhd, Hhd^Fds, Mm, Mm, Mm, Mm, Hhd, Aa, Hh^Fdw, Hh, Gs^Fms, Gs^Fms, Gg, Gs^Fmw, Gs^Fdw, Gg^Efm, Gs, Gg, Gs^Fdw, Gs^Fdw, Hh, Gs^Fms, Ww, Wwf, Wwf, Hh, Gg^Efm, Gg^Efm, Hh^Fds, Aa, Ss, Ss, Hh^Fdw, Hhd^Vhhr, Hhd, Hh^Fmw, Hh^Fds, Hh^Fdw
Hh, Hhd^Fms, Hhd^Fms, Mm, Hh^Fmw, Aa, Aa, Aa, Hh^Vhhr, Hh^Em, Wwf, Gs^Fds, Gg^Efm, Gg, Aa, Aa, Aa, Gg, Hh, Hh, Wwf, Hh, Gg, Hh, Ww, Wwf, Gs^Es, Ww, Gs, Hh^Fds, Wwr, Ss, Hh, Hh^Fdw, Hh^Fdw, Hh^Fmw, Hh^Fms, Hhd^Fms
Hh, Hhd, Hhd, Aa, Hh, Hh^Fmw, Hh^Fdw, Aa, Hh^Em, Hh^Em, Wwf, Wwf, Hh^Em, Hh^Emf, Hh^Em, Hh, Wwf, Hh, Chr, Ww, Hh, Hh, Gs^Fms, Hh, Hh, Wwr, Gg, Gs^Es, Gg, Hh, Ww^Wkf, Aa, Hh^Fdw, Hh, Hh, Hh, Sm, Sm
Hh^Fds, Aa, Aa, Aa, Hh^Fdw, Hh^Fms, Hh^Fms, Hh, Gs^Fds, Hh^Fdw, Gs, Hh, Wwf, Wwf, Ww^Wkf, Ww, Ww, Chr, 1 Khr, Chr, Aa, Aa, Gg^Ve, Gs^Fmw, Gs^Fmw, Wwf, Wwf, Wwf, Gg^Efm, Ww^Wkf, Aa, Aa, Hh^Fdw, Aa, Aa, Ss, Ss, Ss
Hh, Aa, Hh^Fdw, Aa, Gs, Hh, Gs, Hh, Gs^Fms, Gs^Fms, Gg^Efm, Gs, Gs, Hh, Hh^Em, Hh^Em, Ww, Chr, Chr, Chr, Aa, Gs^Fmw, Hh, Hh, Hh, Hh^Fds, Hh^Fds, Hh, Gg^Efm, Gs^Fdw, Gg^Fet, Hh, Gs^Fmw, Gs^Fmw, Aa, Ww^Wkf, Wwr, Ww^Wkf
Hh, Hh^Fdw, Hh, Gg^Efm, Aa, Aa, Aa, Gg^Efm, Gg, Aa, Gg, Gs^Fdw, Gs^Fdw, Gs^Fmw, Gg, Wwr, Wwr, Gs^Fmw, Gs^Fmw, Gg, Gg, Gs^Fms, Gs^Fms, Gs^Fms, Gg, Gs^Fms, Gg, Gg, Gg, Wwf, Wwf, Wwf, Gg, Gs, Gg, Aa, Aa, Aa
