Gll^Fdf, Gll^Fdf, Gll^Fdf, Aa, Aa, Gs^Fp, Gs^Fp, Gs^Fp, Hh, Gg, Mm, Gg, Mm^Xm, Gg, Mm, Gg, Mm, Mm, Hh, Hh, Mm, Gg, Gs, Gll^Fdf, Gll^Fdf, Gll^Fdf, Gll^Fdf, Gll^Fdf, Gll^Fdf, Gll^Fdf, Gs, Gs, Gs, Re, Gs, Gll^Fdf, Gll^Fdf, Gll^Fdf
Gll^Fdf, Gll^Fdf, Gg^Fp, Gg^Fp, Aa, Aa^Fpa, Mm, Gs^Fp, Hh^Fp, Mm, Mm, Mm, Mm, Mm^Xm, Mm, Mm, Mm, Mm, Mm, Mm, Hh, Gg, Gs, Gll^Fdf, Gs, Gs, Gs, Gll, Gll, Gll, Gll, Gs, Gs, Re, Gs, Gll^Fdf, Gll^Fdf, Gll^Fdf
Re, Gll^Fdf, Gs, Aa, Aa, Aa^Fpa, Mm, Gs^Fp, Gs^Fp, Hh, Hh^Fp, Mm, Hh^Fp, Mm, Mm, Mm, Mm, Mm, Hh, Hh, Gg, Gg, Gg, Gs, Mm, Mm, Gs, Gll^Fdf, Gll^Fdf, Gll^Fdf, Gll^Fdf, Gll, Gs, Re, Gs, Gll^Fdf, Gll^Fmw, Gll^Fdf
Gs, Re, Re, Gs, Gs, Aa, Aa, Mm, Gs^Fp, Hh, Hh, Hh^Fp, Hh, Hh, Mm, Mm, Mm, Hh, Gs^Fp, Hh^Fdw, Hh^Fp, Gg, Gg, Gg, Mm, Mm, Gll, Gs, Gs, Gll^Ve, Gd, Gll^Fdf, Gd, Re, Re, Gs, Gll^Fmw, Gll^Fdf
Gg, Gs, Gg^Fp, Re, Re, Gd, Gd, Gs^Fp, Ss, Hh, Hh, Hh, Gs, Hh, Hh, Mm, Hh, Gs^Fp, Hh, Hh^Fdw, Hh^Fp, Mm, Mm, Gg, Mm^Xm, Mm, Gll, Gg^Ve, Gll^Fdf, Gd, Ce, Ce, Ce, Re, Gs, Gs, Hh^Fp, Gll^Fmw
Gll^Fdf, Gg, Gg, Gs, Gs, Re, Re, Gd, Gs, Ss, Gs, Gs, Mm, Gs, Gs, Hh, Hh, Hh, Gs^Fp, Gs^Fp, Hh, Hh, Hh^Fdw, Mm, Mm, Mm, Hh^Fp, Gll, Gll^Fdf, Gd, Ce, 2 Ke, Ce, Re, Gs, Hh^Fp, Hh^Fdw, Hh
Hh, Gd, Ce, Ce, Ce, Gg, Re, Gd, Wwr, Sm, Hh, Hh, Mm, Mm, Gs, Hh, Gs, Mm, Hh, Hh, Hh, Hh, Hh, Hh^Fdw, Hh^Fdw, Mm, Hh^Fp, Gll, Gll, Gll^Fdf, Gd, Ce, Gs, Re, Re, Hh^Fp, Hh^Fp, Hh
Hh, Gd, Ce, 3 Ke, Ce, Gg, Re, Gd, Ww, Hh^Fdw, Hh^Fdw, Hh^Fmw, Hh^Fdw, Mm, Mm, Gs, Mm, Mm, Hh, Mm, Hh, Hh, Mm, Hh, Hh, Hh^Fp, Hh, Hh, Gll, Gll, Gs, Gs, Gd^Vhr, Gs, Re, Gs, Hh, Hh
Hh, Gll^Fdf, Gll^Fdf, Ce, Gd, Gg, Re, Gd, Gs, Gs^Fdw, Gs^Fdw, Gs^Fdw, Hh^Fdw, Hh^Fmw, Mm, Mm, Mm^Xm, Hh^Fp, Hh, Hh, Hh, Hh^Vhh, Gg, Gs, Re, Gs, Gs, Hh, Gs, Gs, Re, Re, Re, Re, Gs, Hh, Hh, Hh
Hh, Hh, Hh, Gg, Hh, Gg^Fp, Re, Gd, Gs, Gs, Gs^Fdw, Gg, Hh^Fmw, Hh^Fmw, Mm, Mm, Mm, Mm^Xm, Mm, Hh^Fp, Hh, Gs, Gg, Gs, Gs, Re, Re, Gs, Re, Re, Gs, Gs, Gs, Hh, Hh, Hh, Hh, Hh
Hh, Hh, Hh, Hh, Hh, Gg, Gg, Re, Re, Gs, Gs, Gg, Hh^Fdw, Hh^Fdw, Hh, Mm, Mm, Mm, Mm, Mm, Gg, Gg, Gg, Gg, Gg, Gs, Re, Re, Hh, Hh, Hh^Fp, Hh^Fp, Gg, Hh, Gg, Gg, Gg, Gg
Hh, Hh, Mm, Mm, Hh, Hh, Gg, Gg, Gs, Re, Re, Gs, Gg, Hh, Hh, Mm, Hh^Fp, Mm, Mm, Mm, Gs, Gg, Gg, Gg, Gg, Gs, Re, Hh, Mm, Hh^Fp, Mm, Gg, Hh^Fdw, Gg, Hh, Mm, Mm^Xm, Gg
Hh, Mm, Mm, Mm, Mm, Hh, Gd, Gg, Gg, Gs, Gs, Re, Gs, Hh, Hh, Hh, Hh^Fp, Mm, Mm, Gs, Hh, Gs, Gg, Gg, Hh, Gs, Re, Hh, Hh, Mm, Hh, Hh^Fdw, Hh^Fdw, Mm, Mm, Mm, Mm, Mm
Hh, Mm^Xm, Mm, Mm, Mm, Hh, Aa, Gd, Gd, Gg, Gg^Fp, Re, Gs, Hh, Aa, Hh, Hh^Fp, Mm, Mm, Hh, Hh, Gs, Mm, Hh, Mm, Hh, Re, Hh, Gg, Hh, Hh, Hh^Vhhr, Hh, Hh^Fdw, Hh^Fp, Mm, Hh^Fp, Mm
Hh, Mm, Mm, Mm, Aa, Mm, Aa, Hh^Fdw, Hh, Gd, Gs, Re, Gs, Aa, Aa, Aa^Fpa, Hh, Hh^Fp, Hh, Mm, Hh, Hh^Fdw, Hh^Fdw, Mm, Hh, Gs, Re, Hh, Gg, Gg, Hh, Hh, Gg, Hh^Fp, Gg, Hh^Fp, Hh^Fp, Hh^Fp
Hh, Mm, Aa, Aa, Aa, Mm, Aa, Hh^Fdw, Hh, Gd, Gs, Re, Re, Gs, Gd, Aa, Aa, Hh, Hh, Hh^Fdw, Hh^Fdw, Hh^Fmw, Gg, Hh, Hh^Fdw, Gs, Re, Hh, Gg, Gg, Hh, Hh, Gg, Gg, Hh, Gg, Gg, Hh
Mm, Mm, Aa, Hh^Fmw, Hh^Fmw, Aa, Aa, Hh^Vhhr, Hh, Gd, Gg, Gd, Re, Gs, Gs^Vh, Aa, Hh, Hh, Hh, Hh, Hh^Fmw, Hh^Fmw, Gg, Gg, Gg, Gs, Re, Gs, Gg, Gg, Hh^Fdw, Hh, Gg, Mm, Mm, Hh, Hh, Gg
Aa, Mm, Aa, Hh, Hh, Hh^Fdw, Hh, Hh, Hh, Gd, Gg, Gd, Gd, Re, Re, Gs, Gs, Hh, Hh, Aa^Fpa, Aa, Hh^Fdw, Gd, Gg, Gs, Gs, Re, Gd, Gg, Gg, Hh^Fdw, Gg, Hh, Mm, Mm, Hh^Fdw, Hh, Hh
Aa, Aa, Aa, Hh^Fdw, Hh, Hh, Hh, Hh^Fdw, Hh^Fdw, Gd, Hh, Gg, Gg, Gd, Gd, Re, Gs, Hh, Aa, Aa^Fma, Aa, Gd, Gg, Gs, Re, Re, Gd, Gd, Gg, Gg, Hh^Fdw, Gg, Mm, Mm, Mm^Xm, Mm^Xm, Mm, Hh
Hh^Fdw, Hh^Fdw, Hh, Hh, Mm, Mm, Hh^Fdw, Hh^Fdw, Hh^Fmw, Hh, Hh, Gg, Gg, Gg, Gs, Re, Gs, Aa, Hh, Aa, Aa, Gd, Gd, Gs, Re, Gd^Vhr, Gg, Gg, Gg, Hh, Gg, Gg, Mm, Mm, Mm, Mm, Mm, Mm
Hh^Fdw, Hh, Hh, Hh, Mm, Mm, Mm^Xm, Mm, Mm, Hh^Fmw, Hh^Fmw, Hh, Hh, Gg, Gs, Re, Gs, Hh, Hh, Aa, Gd, Aa, Gd, Gs, Re, Gs, Gg, Gg, Gg, Hh, Gg, Hh, Hh^Fdw, Mm, Hh^Fdw, Hh^Fdw, Hh, Mm
Hh, Hh, Aa, Aa, Mm, Mm, Mm, Mm, Mm, Mm, Hh^Fmw, Hh, Hh, Gg, Gs, Re, Re, Gs, Gs, Hh, Gg, Gd^Vhr, Gs, Gs, Re, Gs, Gd, Gd, Gg, Gg, Gg, Hh, Hh, Hh^Fdw, Mm^Xm, Hh, Mm, Mm
Hh, Hh, Aa, Gs, Gs, Mm, Gs, Gs, Mm, Mm, Mm, Mm, Gs, Gs, Ww, Gs, Gs, Re, Re, Gs, Gs, Gs, Re, Re, Gs, Gs, Gd, Gg, Gg, Gg, Gg, Hh, Mm, Mm^Xm, Mm, Mm, Mm, Mm
Hh, Hh, Aa, Gs, Gg, Gs, Gg, Gd, Ss, Mm, Hh, Gs, Gd, Ww, Ss, Ww, Ww, Gs, Gs, Re, Re, Re, Aa, Gs, Gg, Gs^Fdw, Gs^Fdw, Hh, Gs^Fdw, Gg, Gg, Mm, Mm, Mm, Mm, Hh^Fdw, Hh, Hh
Hh, Hh, Aa, Gs^Fdw, Gg, Gg, Gg, Gd, Gd, Hh, Gs, Gs, Gd^Fdw, Ss, Ss^Vhs, Gg, Gg, Gg, Re, Gs, Re, Gg, Aa, Aa^Fpa, Gg, Gs^Fdw, Hh^Vhh, Hh, Hh^Fdw, Gs^Fmw, Hh, Hh, Mm, Hh, Mm, Hh^Fdw, Hh^Fdw, Hh
Hh, Aa, Gs, Gs, Gg, Gg, Gg, Gg, Gd, Gs, Gd, Gd, Ss, Sm, Ss, Gg, Re, Re, Gd, Re, Gd, Gg, Aa, Gd, Gs^Fdw, Gs^Fdw, Mm, Mm^Xm, Mm, Hh, Gg, Gg, Gg, Hh, Mm, Hh^Fmw, Hh^Fmw, Hh
Aa, Aa^Fpa, Aa, Gs, Gg, Gg, Gg, Gg, Hh, Gd, Gs^Fdw, Gd, Ww, Ww, Gg, Gg, Re, Gs, Hh, Gd, Aa, Gg, Gg, Gd, Mm, Mm, Mm, Mm, Mm, Hh, Gg, Gd, Gg, Hh^Fdw, Hh^Fdw, Mm, Hh^Fmw, Hh
Gs, Aa, Gs, Gs, Gg, Gg, Mm, Hh, Gg, Gg, Gs^Fdw, Gs^Fdw, Gg, Gg, Gg, Gg, Re, Gs, Hh^Fdw, Hh, Aa, Gg, Hh, Mm, Hh, Hh, Mm, Mm, Mm, Mm, Mm, Gg, Gg, Hh, Hh, Hh^Fdw, Hh, Hh
Hh, Gs, Gs, Mm, Mm, Mm, Mm, Mm, Gg, Gg, Gg, Gg, Gs, Gs, Gg, Gg, Re, Gs, Hh^Fdw, Hh, Aa, Gg, Gg, Hh, Gg, Gg, Gg, Mm, Gs, Mm, Gg, Gg, Gg, Hh, Gg, Hh, Gg, Hh
Hh, Gg, Gg, Mm, Hh, Mm, Gs, Mm, Mm, Gd, Gd, Gd, Aa, Gs, Gs, Gg, Re, Gs, Hh, Hh, Hh^Fmw, Hh^Fdw, Hh, Gg, Gg, Gg, Gg, Hh, Gd^Vhr, Gd, Gg, Hh, Hh, Hh, Gs, Gg, Ww, Ss
Hh, Hh, Mm, Mm, Gs, Gs, Gg, Gs, Hh, Aa, Hh, Aa^Fpa, Aa, Gs^Fmw, Gd, Gg, Re, Gs, Gd^Vhr, Hh, Hh^Fdw, Mm, Mm, Mm^Xm, Mm, Mm, Gg, Hh, Gs^Fdw, Gd, Gs, Gg, Gg, Gg, Gs^Fdw, Gs, Gs^Fdw, Gs^Fdw
Hh, Mm, Mm, Gs, Gs, Gs^Fdw, Gs^Fdw, Hh^Fms, Gg^Fms, Hh^Fms, Hh^Fms, Hh, Hh, Mm, Gs, Gg, Gg, Re, Re, Gs, Hh, Mm, Mm, Mm, Mm, Hh, Hh, Hh^Fdw, Hh^Fdw, Gs^Fdw, Hh, Gs^Fdw, Gs^Fdw, Gs^Fdw, Hh^Fdw, Gs^Fdw, Gs^Fdw, Hh^Fdw
Hh, Mm, Mm, Gs, Gg, Gs^Fdw, Gg, Gg^Fdw, Ss, Ww, Hh^Fms, Hh, Hh^Vhh, Mm, Chr, Chr, Chr, Gg, Re, Gs^Fdw, Hh, Mm, Hh^Fdw, Mm, Gs^Fdw, Hh^Fmw, Hh, Hh, Hh^Fdw, Gs^Fdw, Hh, Hh^Fdw, Hh^Fmw, Gs^Fmw, Hh^Fmw, Hh^Fdw, Hh^Fdw, Hh^Fdw
Hh^Fdw, Mm, Mm, Mm^Xm, Mm, Hh^Fdw, Hh^Fdw, Hh, Hh, Ww, Ww, Ww, Hh^Fdw, Mm, Chr, 1 Khr, Chr, Gg, Re, Gs^Fdw, Hh^Fdw, Hh^Fdw, Ww, Gs^Fdw, Ww, Gs^Fdw, Hh, Hh, Gs, Gs, Gg, Hh, Hh, Hh^Fdw, Hh, Hh, Hh, Hh
Hh, Hh^Fdw, Mm, Mm, Hh, Hh, Hh^Fdw, Hh, Ss, Sm, Ss, Hh^Fdw, Hh, Mm, Mm, Chr, Gs, Gg, Re, Gs^Fdw, Hh, Hh, Ss, Sm, Hh, Hh, Hh, Hh, Hh, Gg, Hh, Gg, Gg, Hh, Hh, Hh, Mm, Mm
Hh, Hh^Fdw, Hh^Fdw, Hh^Fdw, Hh, Hh, Hh^Fdw, Hh^Fdw, Ss, Ss, Ss, Hh, Hh, Hh, Hh, Hh, Re, Re, Gs, Hh, Hh, Hh, Ss, Ss, Ss, Hh, Hh^Fdw, Hh^Fdw, Hh^Fdw, Mm, Mm, Mm, Mm, Mm, Mm, Mm, Mm^Xm, Mm^Xm
