Ha^Fda, Ha, Aa^Es, Aa, Aa^Fda, Aa, Gd^Fp, Gd^Fp, Gd^Fp, Gd, Gd^Fp, Gd^Fdw, Gd^Fdw, Gd^Fdw, Gll^Fmw, Gll^Fmw, Gll^Fmw, Gll, Gll^Esa, Gll, Gd^Fp, Gd^Fp, Gll^Fmw, Gll^Fdw, Gll^Esa, Gll, Gll, Gd^Esa, Gd^Esa, Rb, Gd^Eff, Rb^Es, Gd^Eff, Gll^Esa, Gll^Esa, Gll, Gll^Esa, Gd, Hhd, Hhd, Hhd
Ha^Fda, Ha^Fda, Ai, Aa, Aa^Fda, Aa^Fma, Gd^Fdw, Gd^Fmw, Gd^Es, Gll, Gll^Fmw, Gd^Fmw, Ha^Fda, Gd^Fdw, Aa, Gll^Fmw, Gll, Aa, Aa^Es, Aa, Aa, Gd^Fmw, Wwf, Gll^Fdw, Ai^Es, Aa, Aa^Fda, Gd^Esa, Aa, Rb^Es, Rb^Es, Gd^Eff, Gd^Wm, Gll^Esa, Ai, Aa, Aa^Esa, Gd^Esa, Hhd, Hhd^Esa, Md
Ha, Ai, Sm, Ai, Sm, Gll^Fdw, Ai^Esa, Gd^Fdw, Aa^Es, Gll^Es, Sm, Ha^Fda, Ha^Esa, Aa^Es, Ai, Gll^Fetd, Gll^Esa, Aa^Fda, Aa^Fda, Ai, Sm, Gd, Wwf^Es, Wwg, Wwg, Ai, Wog, Ai, Wwg, Wwf, Rb, Gll^Fdw, Gd^Esa, Ai, Sm, Ai, Sm, Md, Md^Xm, Md, Md
Ss, Sm, Sm, Wwf, Wwf^Es, Ai, Wwf, Aa, Aa^Fda, Ai^Bw|r, Ss, Sm, Ss, Ai, Sm, Gll^Esa, Gd^Esa, Gd^Fdw, Gll^Fmw, Sm, Wwrg, Wwf, Ai, Wwg, Ce^Esa, Wog, Cea, Wog, Rb, Wwf^Bw/, Wwf, Wwg, Wwrg, Wwrg, Gd, Sm, Sm, Md^Xm, Md^Xm, Md^Xm, Md
Ss, Sm, Wwf, Wwf, Wwf^Es, Wwf^Es, Sm, Ai^Esa, Ai^Esa, Ai^Bw|r, Ss^Bw\, Ss, Hhd^Fp, Sm, Sm, Sm, Gd^Es, Gd^Fp, Wwf, Wwrg, Wog, Ai, Ha, Ce^Ebn, Rr^Vhc, Aa^Esa, Aa^Esa, Aa, Rb, Rb^Es, Ha, Cha, Cha^Ebn, Wwrg, Wwf, Wwf^Es, Ai, Md, Md, Md, Hhd
Wwf, Wwf^Es, Ss, Ss, Ss, Ss, Sm, Sm, Wwf, Ss, Sm, Hhd, Hhd, Hhd, Ss, Gll^Fdw, Gll^Es, Gll^Vhr, Gll^Esa, Wwg, Wog, Wog, Rb, Rb, Rr, Rr^Esa, Ch, Rr, Aa^Es, Rra^Es, Aa^Es, Ha, Ch^Esa, Wwg, Aa^Es, Sm, Aa, Md, Ha, Hhd, Hhd
Sm, Wwf, Gll^Fp, Gll^Esa, Ss, Sm, Sm, Wwf^Es, Ai^Esa, Sm, Sm, Ss, Ai, Ai^Esa, Ss, Ss, Ss, Aa, Aa, Wog, Aa, Rra, Rra, Rra^Esa, Aa^Es, Ch, 2 Kha, Cha^Esa, Aa, Rra^Esa, Rra^Vhca, Rra^Esa, Ch^Esa, Wog, Wog, Aa^Fpa, Aa^Feta, Aa^Fpa, Ha^Vhha, Ha, Hhd
Sm, Sm, Aa^Fda, Gll^Fmw, Ha, Hhd^Fdw, Ha, Aa, Aa^Fpa, Aa^Esa, Ss, Ss, Sm, Ai, Gll^Esa, Gll^Esa, Wwf^Es, Wwf, Ai^Esa, Ai, Cha^Esa, Rra, Rra^Vhca, Aa^Es, Aa, Cha^Es, Cha, Ch^Esa, Rr, Rr^Esa, Rra, Rra, Rb, Wog, Wwg, Aa^Es, Aa, Aa^Fpa, Hhd^Fp, Hhd^Fp, Hhd
Aa^Es, Aa^Feta, Aa^Fma, Gll^Fmw, Hhd^Es, Hhd^Vhhr, Ha^Fma, Ha^Fda, Aa^Fda, Ai, Ha, Ai^Es, Sm^Bw/r, Sm^Bw/r, Gll, Gll^Esa, Gd, Ha^Fpa, Ha^Fpa, Ai, Cha, Rra, Aa, Rra, Rr^Esa, Rr, Rr, Aa, Rr, Rra, Rra^Esa, Rb, Wwf^Es, Wwg, Gll, Gll, Gd^Esa, Gd, Gd^Es, Gd^Fp, Hhd
Gd^Es, Aa^Es, Ai^Esa, Ss, Ss, Ss, Ss, Ss, Ss, Ai, Hhd^Fp, Ha, Hhd^Feth, Ai^Esa, Ai^Esa, Ai, Aa, Ha, Hhd, Aa, Aa, Cha^Ebn, Cha, Rb^Esa, Rb, Rb^Es, Ha, Ha, Ha, Aa^Vhca, Cea^Es, Aa, Wwf, Wwg, Wwf, Gll^Es, Aa, Aa, Aa, Gll^Es, Gll
Wwf, Wwf^Es, Sm, Sm, Ss, Ss, Ss, Ai, Sm, Hhd^Fdw, Hhd^Fdw, Gd^Es, Gd, Ai, Ss, Wwf, Wwf^Es, Wwf, Hhd, Ai, Wwg, Wog, Wog, Wog, Ai^Bsb|, Ai, Wog, Cea^Ebn, Ai, Cea, Ai, Ai^Esa, Wwg, Wwf^Es, Sm, Sm, Aa, Aa, Gll, Gll^Esa, Gll^Esa
Wwf^Es, Sm, Sm, Sm, Ai, Wwf, Wwf^Es, Sm, Sm, Ss, Ss, Hhd, Sm, Ss^Vhs, Ss, Wwf^Es, Wwf^Es, Hhd, Ai, Wwf, Wwg, Wwg, Wwg, Wwg, Wwg^Bsb|, Wog, Wwg, Wog, Wwg, Wwrg, Wwf^Es, Wwf, Wwf, Wwf, Sm, Sm, Gd^Fp, Aa, Gd, Gll^Esa, Gll^Fp
Ss, Ss, Ss, Ai^Esa, Aa, Sm, Wwf, Wwf^Es, Ss, Ss, Aa, Sm^Bw|, Sm, Sm, Sm, Sm, Ss, Ss, Ss, Wwf, Wwf^Es, Wwf^Es, Cea, Wwg, Rra^Es, Wwg, Cea, Gll^Es, Aa, Wwf, Gll^Fmw, Gd^Fmw, Gd^Fdw, Gd, Gll^Es, Gll^Fmw, Gll^Fdw, Gd, Gd^Esa, Gll^Fmw, Gd^Fdw
Ss, Ss, Ss, Ss, Sm, Sm, Ss, Sm, Ss, Aa^Fda, Aa, Gll, Ai, Ai^Esa, Ss, Sm, Ai, Ai^Esa, Sm, Sm, Aa^Fda, Cea^Esa, Rra^Vha, Rra, Rr^Es, Rra^Es, Ha, Cea^Es, Aa, Aa, Gll^Es, Aa^Fda, Aa, Gd, Gll^Eff, Gll^Fdw, Aa, Gd, Aa, Gd, Hhd
Hhd^Fmw, Ss, Hhd^Fdw, Sm, Sm, Ss, Ss, Sm, Sm, Aa, Gd^Es, Gll^Es, Hhd, Ss, Aa, Aa, Aa^Fda, Ai, Aa, Sm, Aa, Rra, Aa, Rra^Esa, Aa^Feta, Rr^Vhc, Rra, Ha, Aa^Esa, Gll^Es, Gd^Es, Aa, Gd^Esa, Gll^Eff, Rb^Es, Aa^Eff, Aa^Es, Ha, Ha, Hhd, Hhd
Hhd^Fp, Hhd^Fmw, Hhd^Fmw, Ha^Fpa, Ha^Fpa, Aa^Fpa, Aa^Es, Sm, Ha^Fma, Ha^Esa, Gd^Esa, Gd^Es, Hhd, Hhd, Hhd^Fmw, Gll^Fmw, Gll^Fdw, Gll, Gd^Esa, Gd, Ha^Es, Ha, Cea^Ebn, Rr, Rr^Vh, Rr, Ce, Rra^Esa, Rb^Esa, Wwf, Sm, Gd^Esa, Gll^Vl, Rb^Es, Rb, Rb^Esa, Rb^Es, Ha, Hhd, Hhd^Esa, Hhd
Ha^Fpa, Ha, Hhd^Fp, Ha, Ha, Aa^Fma, Aa^Esa, Gd^Es, Gll^Fmw, Hhd^Fmw, Gd, Gll, Hhd, Ha, Ha^Fma, Ha^Fda, Rb, Rb^Esa, Rb^Esa, Rb^Es, Aa, Ha, Aa, Rr, Rb, Rra^Esa, Aa, Aa^Es, Ai, Sm^Bw\, Rb, Gll, Aa, Gll, Gd^Eff, Rb, Gll^Eff, Aa, Gll, Hhd^Fmw, Gll^Fmw
Ha^Fpa, Ha^Fpa, Hhd^Vhr, Gd^Fp, Gd, Aa, Hhd^Fmw, Gll, Gll^Esa, Gd^Fp, Gll^Esa, Gll^Esa, Gd^Es, Hhd, Ha, Ha^Fda, Rb^Es, Gd, Gd, Gd, Gd^Fdw, Aa^Fda, Gll^Fmw, Gll^Es, Rb^Es, Gll, Hhd, Aa, Hhd^Fdw, Hhd^Fdw, Hhd^Fdw, Rb^Es, Aa, Aa^Esa, Gd^Esa, Gd^Eff, Gd^Fmw, Gll^Fmw, Gd, Gll^Fp, Gll^Fp
Ha, Ha, Hhd, Hhd, Gd, Gd^Qhh, Hhd^Qhhf, Hhd^Qhhf, Hhd^Qhh, Gd^Qhh, Gll^Qhh, Gll^Esa, Gll^Es, Gd^Es, Gd, Gd^Es, Rb, Hhd, Hhd, Md^Xm, Md^Xm, Hhd^Fdw, Hhd, Gll^Esa, Gd^Es, Rb, Hhd^Esa, Md, Md, Hhd^Fmw, Md, Md, Md, Rb^Esa, Rb^Esa, Rb, Rb, Gd^Fdw, Rb, Gd^Fp, Rb
Gll^Es, Aa^Es, Gd^Es, Gd^Es, Gd^Qhh, Gd^Qhh, Ce^Edb, Ce^Edb, Cea^Esa, Aa^_mh, Aa^Qhh, Aa, Rb, Rb, Rb^Esa, Rb, Aa, Hhd, Md, Md^Xm, Md, Md^Xm, Md, Md, Gll^Fmw, Rb, Aa, Hhd^Es, Md, Md, Md, Md, Md^Xm, Md, Gll, Gll^Es, Gll^Fp, Rb, Aa^Es, Rb^Esa, Aa^Fpa
Gll^Esa, Gll^Esa, Gd, Gd, Gll^Qhh, Gd^Es, Hhd^Edb, 1 Kea, Cea^Esa, Cea^Esa, Aa^Qhh, Ha^Qhh, Aa, Ha^Vca, Ha, Rb^Es, Aa^Fpa, Md, Md, Md, Md, Md, Md, Md, Hhd^Fp, Gll^Fp, Rb, Hhd^Vc, Md, Md, Md, Md^Xm, Md^Xm, Md, Md, Hhd^Fp, Hhd^Fp, Gd^Esa, Gll, Aa^Fma, Aa^Fpa
Ha, Aa, Aa^Es, Gll, Gll^Qhh, Hhd, Ha^Qhh, Cea, Hhd^Fdw, Hhd^Fetd, Md^Qhh, Md^Xm, Md, Ha, Gd, Rb, Rb, Aa^Fpa, Ha^Fpa, Ha, Aa, Hhd^Fdw, Hhd^Fdw, Hhd, Gll^Es, Gll^Es, Rb, Ha^Fma, Ha^Fma, Md, Md, Md, Md, Md, Md, Md, Md, Hhd^Fetd, Gll^Es, Aa, Aa
Ha, Ha^Esa, Ha^Es, Gll^Es, Aa, Aa^Qhh, Ha, Ha^Qhh, Hhd^Qhh, Md^Qhh, Md, Md, Ha, Ha^Es, Gd^Esa, Gd, Aa, Aa^Fpa, Aa, Aa^Es, Aa^Es, Aa^Esa, Gll^Esa, Gd, Gd^Esa, Rb^Es, Aa, Aa^Fda, Ha, Md, Hhd^Fp, Md, Hhd^Fp, Md, Hhd, Md, Hhd^Fp, Hhd, Gd, Gd^Fp, Gd^Fp
Ha^Fma, Ha^Fpa, Ha^Fpa, Gd^Fp, Gll^Fp, Aa^Fpa, Aa, Ha, Hhd^Fp, Hhd^Fdw, Gd^Fmw, Md, Gd, Gd^Esa, Gd, Gd, Gll^Es, Aa, Aa, Aa^Es, Ha, Ha, Md, Gd, Gll^Feth, Rb, Gd, Aa, Gd^Es, Hhd, Hhd^Esa, Hhd^Fp, Gll^Fp, Hhd^Fp, Gd, Hhd, Gd^Fp, Hhd^Fp, Gd^Es, Gd^Fp, Gd^Fmw
Hhd^Fmw, Ha^Fma, Hhd^Fp, Gll^Fp, Gll^Fp, Aa^Fpa, Gll^Fp, Gll^Esa, Gd, Gd^Fp, Gd, Gd, Gd^Es, Gd, Aa, Gd, Aa, Gll, Gll^Esa, Gll, Md, Ha, Md, Hhd^Fp, Aa, Rb^Esa, Rb, Gd, Gll^Es, Hhd^Es, Md, Gll^Fp, Hhd^Fp, Gll^Fp, Aa, Aa, Aa, Gll^Esa, Gll^Fmw, Gll^Es, Gll^Fp
Hhd^Fp, Hhd^Fp, Hhd^Fdw, Hhd^Fmw, Hhd^Fmw, Gll^Fp, Gll^Fp, Gll, Gd^Fp, Gll, Gll^Fp, Gll^Esa, Gll, Hhd, Ha, Aa, Ha^Es, Hhd^Vhh, Hhd^Esa, Md, Md^Xm, Md, Md^Xm, Hhd, Ha, Aa, Rb, Gll^Esa, Hhd^Esa, Md, Md, Md, Md, Hhd, Hhd, Aa^Fpa, Ha^Fpa, Gll^Fp, Gll^Fmw, Gll^Fdw, Gll^Fp
Hhd^Fp, Hhd^Fp, Hhd^Fp, Hhd^Fmw, Hhd^Fp, Hhd^Fp, Gll, Gll^Fp, Gll^Fp, Gll^Fp, Gll, Gll, Hhd, Hhd, Hhd, Ha, Hhd, Hhd^Esa, Hhd, Hhd, Md, Md^Xm, Md^Xm, Md, Ha, Aa, Aa, Ha^Esa, Ha, Md, Md, Md, Md, Md, Hhd, Ha, Ha^Fpa, Aa^Fpa, Gll^Fp, Gll^Fp, Gll
