Gs^Fds, Gs^Fds, Re, Hh^Fmw, Hh^Fds, Gg, Gs^Fmw, Gs^Fmw, Wwr, Gs^Fms, Hhd^Fmw, Hhd, Hhd^Fp, Hhd, Hhd^Em, Hhd^Fp, Hhd^Fms, Mm, Mm, Hhd^Fdw, Hh^Fdw, Ss, Ss, Ss, Sm, Ss, Ss, Ss, Wwf, Ww, Wwr, Re, Gg, Gg^Efm, Hh^Fmw, Hh^Fms, Hh^Fms, Gg
Gg, Gs^Fms, Re, Hh^Fmw, Re, Gg^Fet, Gs^Fms, Wwr, Ww^Wkf, Gs^Fds, Hhd^Em, Mm, Mm, Mm, Mm, Hhd^Fp, Hhd^Em, Mm, Mm, Mm, Hh^Fdw, Ss, Sm, Sm, Aa, Sm, Sm, Ww^Wkf, Wwr, Gg^Efm, Gs, Re, Ce, Hh, Aa, Aa, Gs^Fms, Aa
Gs^Fms, Re, Ce, Ce, Ce, Re, Gs^Fds, Ww, Gs^Fds, Hh^Fds, Aa, Hhd^Fmw, Hhd^Fms, Mm, Mm, Mm, Mm, Mm, Mm, Mm, Hh, Wwf, Sm, Aa, Hhd, Aa, Aa, Hh, Hh^Fmw, Gg, Gs, Ce, 3 Ke, Ce, Gs, Aa, Aa, Gs^Fms
Hh^Fmw, Re, Ce, 2 Ke, Ce, Gs^Fds, Re, Wwf, Gs^Fds, Aa, Gs^Fms, Aa, Mm, Mm, Mm, Mm, Mm, Mm, Mm, Mm, Hh^Em, Ww^Wkf, Hhd^Fms, Hhd^Fmw, Mm, Hhd^Fdw, Hhd^Em, Hh^Fms, Gs, Gg^Efm, Gs, Ce, Ce, Ce, Re^Es, Gs, Gs, Gs
Gs^Fmw, Re, Gs^Fdw, Ce, Gg^Efm, Wwf, Gs^Fms, Re^Es, Re^Es, Re, Re, Aa, Hh, Mm, Mm, Mm, Mm, Mm, Mm, Hhd^Fms, Hhd^Em, Hhd^Fms, Mm, Mm, Mm, Mm, Hhd^Vhhr, Gs^Es, Gs^Fmw, Gg^Efm, Gg^Efm, Gs, Gs, Re^Es, Gs^Fms, Gs^Ve, Re^Es, Gs^Fms
Re, Gs^Fmw, Gs^Fmw, Gs^Fmw, Gs^Fdw, Wwf, Wwf, Gs^Ve, Aa, Gs^Fmw, Gs^Fds, Hh, Mm, Mm^Xm, Mm, Mm, Mm, Mm, Mm, Mm, Mm, Mm, Mm, Mm, Mm, Mm, Hh^Fms, Gs^Es, Gs^Fmw, Gs^Fmw, Wwf, Aa, Aa, Aa, Aa, Gs^Fms, Gs^Fms, Re
Gs^Fmw, Re, Re, Re^Es, Re^Es, Ww^Wkf, Wwr, Hh^Fms, Gg^Efm, Gs, Gg^Efm, Hh^Fds, Hh^Fdw, Mm, Mm, Mm, Mm, Mm, Hh^Fmw, Mm, Mm, Mm, Aa, Hh^Fdw, Hh^Fmw, Hhd, Gg^Efm, Gg, Wwf, Wwf, Sm, Wwf, Gs^Fmw, Hh, Hh^Fms, Aa, Aa, Gs^Fms
Gs^Fmw, Gs^Fms, Aa, Gs^Ve, Re^Es, Gs^Fds, Wwf, Ww, Gg, Re, Re, Aa, Hh, Mm, Mm, Mm, Mm, Mm^Xm, Mm, Hh^Fdw, Hh, Aa, Hh, Gg^Efm, Wwf, Gs^Fds, Gs^Fds, Gs^Fds, Wwr, Ss, Sm, Sm, Hhd, Hh^Fmw, Mm, Hh, Hh, Gs^Fds
Hhd, Hhd, Aa, Hh^Fmw, Gs^Fms, Gs^Fds, Gs^Fds, Gs^Fds, Gs^Fms, Gs, Re, Aa, Aa, Hh, Hh^Fdw, Hh^Fmw, Mm, Mm, Hh, Hh^Fmw, Aa, Aa, Hh, Wwf, Wwf, Wwf, Ww^Wkf, Gs^Fds, Ww^Wkf, Ss, Ss, Hh, Mm, Mm, Mm, Hh^Fms, Hh^Fms, Hh
Hhd, Hh^Fdw, Aa, Hh^Fmw, Gg^Efm, Gg^Efm, Gs^Fds, Gs^Fds, Wwf, Gs^Es, Gs^Fmw, Re, Gg, Aa, Aa, Mm, Mm, Mm, Mm, Hh, Hh^Fdw, Hh, Ww, Wwr, Hh, Wwr, Gs^Fmw, Re, Gg^Fet, Wwf, Wwf, Hh^Fdw, Mm, Mm, Mm, Mm, Hhd^Fds, Hh
Hhd, Hh, Hh, Aa, Aa, Gs^Fds, Gg^Efm, Ww, Ww^Wkf, Gg^Efm, Gs^Fmw, Gs^Fmw, Wwf, Wwf, Gs^Fds, Mm, Mm, Mm, Mm, Mm, Hh^Fdw, Re, Re, Hh^Fmw, Ww^Wkf, Wwr, Gs^Fmw, Re, Gg^Efm, Gg, Hh, Mm, Mm, Mm, Hh^Fdw, Hhd^Em, Hhd^Emf, Hh^Fms
Hh, Hh, Hh, Hh^Fdw, Hh^Fmw, Aa, Aa, Gs^Ve, Gs^Es, Ww^Wkf, Wwr, Ww, Gs^Fds, Wwf, Wwf, Gs^Fds, Gs^Fms, Mm, Hhd^Fp, Hhd^Fmw, Hh, Aa, Gg^Efm, Ww^Wkf, Gs^Fds, Gs^Fds, Gs, Gg^Efm, Gs^Ve, Gs^Fds, Hh^Fms, Hh^Fdw, Hh^Fdw, Hh^Fdw, Hh, Hh^Em, Hhd^Fms, Hhd^Em
Hh^Fdw, Hh^Fdw, Hh^Fmw, Hh^Em, Hhd^Emf, Hh^Em, Hh^Fmw, Gs^Fms, Gs^Es, Wwr, Gs^Fmw, Gs^Fds, Wwf, Gs^Fds, Gs^Fmw, Hh^Fmw, Aa, Aa, Aa, Hh, Aa, Hh, Gg^Efm, Ww, Gs^Fmw, Gg, Gs, Gs^Fds, Gs^Fdw, Gs^Fmw, Hh, Hh, Mm, Hh^Fmw, Mm, Mm, Mm, Hhd^Em
Hh, Hh^Fds, Hhd^Fds, Hhd^Em, Mm, Hh^Em, Hh^Fdw, Gs^Fms, Gs^Fdw, Re, Gs^Fmw, Ww^Wkf, Gs^Fdw, Gg, Gs^Fmw, Gs, Wwf, Gs^Fds, Gs^Fds, Aa, Gs^Ve, Gg^Efm, Gs^Fms, Gs^Fmw, Gs^Fms, Gg^Efm, Ww, Wwr, Ss, Aa, Mm, Mm, Mm, Mm, Mm, Mm, Hh^Fmw, Hh^Fdw
Hhd, Hh^Fdw, Mm, Mm, Mm, Mm, Hh, Gs^Fmw, Gs^Fmw, Re, Gg^Efm, Wwr, Wwf, Wwf, Re, Re, Gs^Fds, Wwf, Wwf, Gs^Fms, Re, Re, Gs^Es, Gs^Fms, Hh^Fmw, Gg, Gs, Re, Ss, Aa, Hh, Hh^Fmw, Hh^Fdw, Mm, Mm, Mm, Hh^Em, Hh^Fdw
Hhd, Mm, Mm, Mm, Mm, Mm, Mm, Aa, Hh^Fdw, Gs^Fds, Gg, Re, Wwf, Gs^Fmw, Gg^Efm, Gs^Efm, Hh^Fms, Hh^Fms, Gg^Es, Gg^Es, Gs^Fms, Gs, Ww^Wkf, Wwr, Wwf, Hh^Fds, Gg, Re, Hh, Aa, Aa, Hhd, Hh, Mm, Hh^Fmw, Hh^Fdw, Hh^Em, Hh^Emf
Hhd, Hhd^Fds, Mm, Mm, Mm, Mm, Hhd, Aa, Hh^Fdw, Hh, Gs^Fms, Gs^Fms, Gg, Gs^Fmw, Gs^Fdw, Gg^Efm, Gs, Re, Gs^Fdw, Gs^Fdw, Hh, Gs^Fms, Ww, Wwf, Wwf, Gs^Fmw, Gg^Efm, Gg^Efm, Hh^Fds, Aa, Sm, Ss, Hh^Fdw, Hhd^Vhhr, Hhd, Hh^Fmw, Hh^Fds, Hh^Fdw
Hh, Hhd^Fms, Hhd^Fms, Mm, Hh^Fmw, Aa, Aa, Aa, Hh^Vhhr, Hh^Em, Wwf, Gs^Fds, Gg^Efm, Gg, Aa, Aa, Aa, Re, Hh, Hh, Wwf, Hh, Gg, Re, Ww, Wwf, Gs^Es, Ww, Gs, Hh^Fds, Wwr, Ss, Hh, Hh^Fdw, Hh^Fdw, Hh^Fmw, Hh^Fms, Hhd^Fms
Hh, Hhd, Hhd, Aa, Hh, Hh^Fmw, Hh^Fdw, Aa, Hh^Em, Hh^Em, Wwf, Wwf, Hh^Em, Hh^Emf, Hh^Em, Hh, Wwf, Hh, Chr, Ww, Hh, Hh, Gs^Fms, Re, Re, Wwr, Gg, Gs^Es, Gg, Hh, Ww^Wkf, Aa, Hh^Fdw, Hh, Hh, Hh, Sm, Sm
Hh^Fds, Aa, Aa, Aa, Hh^Fdw, Hh^Fms, Hh^Fms, Hh, Gs^Fds, Hh^Fdw, Re, Hh, Wwf, Wwf, Ww^Wkf, Ww, Ww, Chr, 1 Khr, Chr, Aa, Aa, Gg^Ve, Gs^Fmw, Gs^Fmw, Wwf, Wwf, Wwf, Gg^Efm, Ww^Wkf, Aa, Aa, Hh^Fdw, Aa, Aa, Ss, Ss, Ss
Hh, Aa, Hh^Fdw, Aa, Gs, Hh, Gs, Hh, Gs^Fms, Gs^Fms, Gg^Efm, Gs^Fds, Gs, Hh, Hh^Em, Hh^Em, Ww, Chr, Chr, Chr, Aa, Gs^Fmw, Hh, Hh, Hh, Hh^Fds, Hh^Fds, Hh, Gg^Efm, Gs^Fdw, Gg^Fet, Hh, Gs^Fmw, Gs^Fmw, Aa, Ww^Wkf, Wwr, Ww^Wkf
Hh, Hh^Fdw, Hh, Gg^Efm, Aa, Aa, Aa, Gg^Efm, Gg, Aa, Gg, Gs^Fdw, Gs^Fdw, Gs^Fmw, Gg, Wwr, Wwr, Gs^Fmw, Gs^Fmw, Gg, Gg, Gs^Fms, Gs^Fms, Gs^Fms, Gg, Gs^Fms, Gg, Gg, Gg, Wwf, Wwf, Wwf, Gg, Gs, Gg, Aa, Aa, Aa
