Mm, Hhd, Hh, Hhd, Hh^Fmw, Hh, Mm, Mm, Mm, Hhd, Hhd, Hhd, Hh^Fmw, Hhd, Mm, Hh, Aa, Aa, Hh, Hh^Em, Hh^Emf, Hh^Em, Mm^Xm, Hh, Hh^Em, Hh, Hh, Gg, Gg^Efm, Gs, Ww^Wkf, Ww^Wkf, Re, Ds, Ds, Gs^Fms, Gs^Efm, Gg
Hhd, Mm, Mm, Hh^Em, Hh^Fmw, Mm, Mm, Mm, Mm, Mm, Mm, Hh^Em, Mm, Mm, Hh^Fdw, Hh, Aa, Hh^Vhh, Mm, Mm^Xm, Mm, Mm, Mm, Mm, Mm, Mm, Hh, Hh, Gd^Es, Gs^Es, Wwr, Ww, Re, Ds, Gs^Fmw, Gs^Fmw, Gd^Es, Gg^Efm
Hh, Hh^Fmw, Chr, Chr, Chr, Hh^Em, Mm, Mm, Mm, Mm, Hh^Fmw, Hh^Em, Aa, Hh^Fmw, Gd^Es, Gd^Es, Aa, Hh, Hhd, Mm, Aa, Hhd, Hhd, Mm, Gg, Gs^Efm, Gg, Gg^Ve, Wwf, Ww, Re, Wwr, Re, Ds, Hh^Em, Gs^Es, Hhd^Fdw, Gg
Hh, Hh^Em, Chr, 1 Khr, Chr, Aa, Aa^Es, Mm, Gd, Aa, Aa, Aa, Gg^Efm, Gs^Es, Gg, Gg, Gg, Aa, Aa, Aa, Gd, Hh, Gs^Efm, Gs^Efm, Re, Gg, Re, Gg, Ww, Ww^Wkf, Gs^Fmw, Re, Ds, Ds, Hh^Emf, Hh^Fp, Mm, Hhd
Hhd^Fmw, Hhd, Gg^Efm, Chr, Gs, Gd^Efm, Gs^Efm, Gs, Gg, Gg, Gg, Gg, Gs, Gd^Efm, Hh^Fdw, Hh, Gs^Fms, Gs, Gs^Efm, Gg^Efm, Gs^Fmw, Gs^Fdw, Gg^Efm, Rr, Re, Re, Ww^Ewl, Rr, Aa, Ww, Gs^Fdw, Gg^Fet, Hh, Hh^Em, Mm, Mm, Mm, Mm
Hhd, Gd^Es, Gg, Gg, Gg, Gs^Vh, Gg, Gg, Ds, Rr, Rr, Gg, Hh^Em, Hh^Fmw, Hh, Rr, Rr, Gs^Fmw, Rr, Re, Re, Re, Rr, Rr, Gs, Re, Ai, Ww, Aa, Ww^Wkf, Gg, Gs, Hh, Mm, Mm, Mm, Hh, Hh
Gd, Gs, Rr, Gs, Hh^Em, Gg^Em, Hh^Emf, Gs^Es, Gd^Em, Ds, Rr, Hh, Mm, Mm, Hh^Vhh, Rr, Gs^Fmw, Gs^Fmw, Rr, Rr^Vhc, Re^Efm, Rr, Re, Re, Re, Gd, Re, Ww^Wkf, Ww^Wkf, Aa, Gg^Efm, Gd^Efm, Hh, Hh^Fdw, Hh^Fp, Hh, Hhd^Em, Hh^Em
Gg, Rr, Hhd, Hh, Mm, Mm, Mm, Hh^Em, Gs^Efm, Gs^Fmw, Hhd, Mm, Mm, Mm, Mm, Hh^Fp, Hh, Rr, Rr, Re^Efm, Gs^Fdw, Gll^Efm, Gll, Gll, Wwf, Ds, Wwr, Gll, Ww, Aa, Wwf, Wwf, Gd, Gs^Fdw, Rr, Rr, Hhd^Emf, Hhd^Em
Gs, Rr, Mm, Mm, Mm, Mm, Hh^Fp, Mm, Gg, Gs^Fms, Mm, Mm, Mm, Mm, Hhd, Hh^Fp, Rr, Rr, Kh, Gd^Fmw, Ww^Wkf, Wwr, Wwr, Wwr, Wwf, Ds, Ww, Ww^Bsb|, Ww, Ww, Wwf, Aa, Gd^Es, Gs^Fmw, Gs^Fmw, Hh^Em, Hh^Em, Hh^Em
Hhd, Mm, Mm, Mm, Hh, Hh^Fdw, Aa, Aa, Gg, Gg, Hhd^Fmw, Mm, Hh, Hh^Fp, Gg^Efm, Rr, Re, Re, Ch, Ww, Ds, Ds, Ww^Wkf, Wwf, Ww^Wkf, Ww, Ww, Ww^Bsb|, Rr, Aa, Aa, Aa, Rr, Rr, Gs^Fmw, Rr, Rr, Rr
Hh, Hh, Hh^Fp, Hhd, Hh^Fdw, Wwf, Gs^Es, Gd, Rr, Rr, Hh, Hhd, Rr, Gg^Efm, Gs^Efm, Re, Rr, Gll^Efm, Gll^Es, Gll^Es, Ds, Ww^Ewl, Wwf, Wwf, Ww^Ewf, Ww^Ewl, Aa, Rr, Ch, Rr, Rr, Rr, Gg, Gs, Gs^Es, Re, Re, Re
Gd, Wwf, Wwf, Hh^Fdw, Wwf, Wwf, Gs, Rr, Re, Rr, Rr, Rr, Rr, Re^Es, Rr, Rr, Ww^Wkf, Ww, Wwr, Wwr, Wwr, Ww, Wwf, Ch, Re^Es, Aa, Gd, Aa, Aa, Gd, Gs, Gs, Gg^Efm, Gg, Kh, Gd, Gs^Fmw, Gd^Fmw
Gg, Aa, Aa, Wwf, Aa, Wwf, Gg^Ve, Re, Re, Re, Re, Re, Re, Re^Es, Ww^Bsb|, Ww, Ww^Wkf, Wwf, Wwf, Wwf, Aa, Aa, Aa, Re, Gd, Gs^Es, Aa, Rr, Rr, Rr, Rr, Gs^Efm, Gd, Ch, Gg, Gg, Gs^Ve, Gs^Efm
Gg, Gg^Efm, Gs^Efm, Aa, Gd^Es, Gs, Re, Re, Ai, Aa, Ww^Ewl, Wwr, Wwf, Ww, Ww^Bsb|, Ww, Re, Rr, Re, Rr^Vhc, Gg, Gg, Gg^Efm, Gs, Rr^Vhc, Gs, Gg, Gg, Re^Wm, Re, Rr, Rr^Vhc, Re^Es, Gd^Fdw, Ch, Re, Re, Gs
Gg, Gs, Gg, Gd, Gg, Gll, Wwr, Wwf, Ww^Wkf, Ww^Wkf, Ww^Wkf, Wwr, Wwr, Wwr, Ww^Bsb|, Ww, Ch, Re, Gs, Gg^Efm, Ch, Gs^Efm, Aa, Gg^Efm, Ch, Kh, Gd, Re, Rr, Rr, Ch, Gd, Re^Es, Ch, 2 Kh, Ch, Rb, Re
Gg^Efm, Gd, Gg^Efm, Gg, Re, Gll, Wwr, Ww, Ww^Wkf, Ww^Ewl, Re, Wwf, Rr, Rr, Ch, Kh, Ds, Ds, Ds, Gd^Efm, Aa, Aa, Rr^Vhc, Aa, Re^Gvs, Re^Gvs, Re^Gvs, Gd, Rr, Re, Re, Rr, Re, Ch, Ch, Ch, Aa^Es, Rb
Gs^Efm, Gs^Efm, Gd^Es, Gll^Es, Wwf, Wwf, Ww^Ewl, Wwf, Aa, Aa, Aa, Re, Re, Re, Rr, Gd^Es, Rr, Rr, Hh^Em, Gs, Re^Gvs, Rr, Re^Gvs, Re^Gvs, Re^Gvs, Re^Gvs, Re^Gvs, Re^Gvs, Hh^Em, Rr, Rr, Rr, Rr^Vhc, Re, Aa, Aa, Re, Aa
Aa, Aa, Aa, Wwf, Ww, Ww^Wkf, Re, Re, Rr, Rr, Rr, Rr, Rr, Rr, Rr, Gs, Rr, Hh^Fdw, Re^Gvs, Re^Gvs, Re^Gvs, Re^Gvs, Re^Gvs, Re^Gvs, Re^Gvs, Re^Gvs, Re^Gvs, Re^Gvs, Hh, Rr, Re, Rr, Rr, Re, Rr, Rr, Rr, Re
