Gs^Fdw, Gs^Fdw, Gs^Fdw, Gg, Gg, Re, Re, Gg, Gg, Gg, Gg, Gg, Gg, Gg, Hh^Fp, Hh, Hh, Hh, Hh^Fp, Hh, Hh^Fp, Aa, Aa, Hh, Hh, Hh^Fp, Hh, Hh, Hh^Fp, Hh, Hh, Hh, Hh^Fp, Hh^Fp, Hh^Fdw, Hh^Fp, Hh^Fp, Hh, Re, Gs, Aa, Aa, Aa, Aa, Gs, Gg, Gg^Efm, Gg^Efm
Gs^Fdw, Gs^Fdw, Gs, Gg, Gg, Gs, Gs, Re, Re, Gg, Rr, Rr, Rr, Gs, Gg, Gg, Hh^Fdw, Hh, Hh^Fdw, Hh^Fdw, Aa, Aa, Hh^Em, Hh^Emf, Hh^Em, Hh, Aa, Hh, Hh^Fdw, Aa, Hh^Em, Hh^Emf, Hh^Em, Hh, Aa, Hh, Aa, Aa, Re, Gs, Gs^Vh, Gs, Gs, Gs, Gg, Gg^Efm, Gg, Gg
Gs^Fdw, Gs, Gs^Fdw, Aa, Gg, Gs^Vh, Gs, Re, Chr, Chr, 1 Khr, Chr^Edb, Rr, Gs, Gs^Vh, Gs, Hh, Hh^Fdw, Aa, Aa, Hh, Hh, Aa, Aa, Aa, Aa, Gs, Gs, Aa, Aa, Hh, Hh^Em, Aa, Aa, Gs, Aa, Re, Gs, Re, Gs, Gg, Gg, Gg, Gg, Re, Gg, Gs, Gs
Gg, Gs^Fdw, Aa, Aa, Gs^Fdw, Gg, Gs^Fp, Re, Re, Chr^Edb, Chr^Edb, Chr^Edb, Re, Gs, Gg, Hh^Fp, Hh, Aa, Gs, Gs, Gs, Gs, Re, Re, Re, Gs, Gg, Gg, Re, Gs, Gs, Gs, Ds, Ds, Ds, Ds, Ww, Gs, Gs, Re, Re, Re, Ww, Wwr, Ww, Re, Re^Es, Re
Aa, Gs^Fdw, Aa, Gs^Fdw, Gs^Fp, Gg, Gg, Gs, Gs, Re^Es, Re^Es, Re^Es, Gs, Gg, Gs, Hh, Gs, Gs, Gg, Aa, Gs, Gs, Re, Ds, Ds, Ds, Ww^Ewl, Re, Ds, Re, Ds, Ds, Wwf, Ww, Ww, Ww, Ww, Ww, Ww, Gg, Ww, Wwf, Wwf, Ww, Ww, Ww^Ewl, Ww^Ewl, Ww^Ewl
Gs, Aa, Gs, Gs^Fdw, Gs^Fp, Gs^Fp, Gg, Gs^Fdw, Gg, Gs, Gg, Gs, Gs^Vl, Gg, Gg^Efm, Gs, Gg, Gg, Gg, Gs, Re, Re, Wwf, Ww, Ww, Ww, Ww, Ww^Ewl, Ww, Ds, Ww, Wwf, Wwf, Wwf^Es, Re^Es, Ww, Re, Ww, Ds, Wwr, Ds, Ww, Rr^Vhc, Re, Re, Ww, Ww, Ww
Gg, Gs, Gg, Gs^Fdw, Gs^Fp, Gg, Gs^Fp, Gs^Fp, Gg, Gg^Efm, Gg, Gg, Gs, Gg, Re, Gg, Gg, Gg, Ds, Re, Ww, Wwf, Wwf, Wwf, Re, Ds, Gs, Ww, Ds, Wwr, Ww, Ww, Re, Re, Gg, Re, Gs, Gs, Re, Ds, Gg, Gg, Re, Gs, Ch, Re, Ch, Gg
Gg, Gs^Vh, Gs, Gs^Fdw, Gs, Gg, Gg, Gg, Gg^Efm, Gg^Efm, Gg, Gs, Re, Re, Ds, Re, Ds, Ds, Ww, Ww, Ww, Ww, Re, Re, Re, Gg, Gs^Vh, Ds, Gs, Ds, Gs^Vh, Gs, Gg, Gg^Efm, Gs^Fdw, Gg, Hh^Fdw, Gs, Gs, Gs^Fdw, Gs^Fdw, Gs^Fdw, Re, Ch, 5 Kh, Ch, Rr, Ch
Gg, Gg, Gs, Gs, Gs, Gs, Gg, Gg, Gg, Gg, Gs, Gs, Re, Ds, Wwr, Ds, Ww, Ww, Ww, Ww, Ds, Gs, Gs, Gs, Gs, Re, Re, Gg, Gg, Gs, Re, Re, Re, Gg, Gs^Fdw, Hh^Fdw, Gs^Fdw, Gs^Fdw, Gs, Gs, Gs, Gg, Re, Ch, Ch, Ch, Re, Rr
Gg, Gg^Efm, Gg^Efm, Gg^Efm, Gg, Gg, Gg, Gg, Gs, Gs, Re, Re, Ww, Ww, Ww, Ww, Ww, Ww, Ds, Ds, Gs, Gs, Gd^Gvs, Gd^Gvs, Gd^Gvs, Gs, Gg, Re, Re, Re, Ch, Ch, Re, Gs, Gs, Gg, Re, Re, Gs^Fp, Hh^Fp, Hh^Fp, Gs^Fdw, Gs^Fdw, Re, Gs^Fp, Re, Hh, Gs^Fp
Gg, Gg, Gg, Gg, Ds, Ds, Ds, Ds, Ds, Ds, Ds, Ww, Ww, Ww, Ds, Ww, Ds, Ds, Gs, Gs, Gs, Gd^Gvs, Gd^Gvs, Gd^Gvs, Gd^Gvs, Gs, Gg, Gg, Ch, Re^Es, Re^Es, Rr, Rr, Ch, Ch, Gs, Re, Gs^Fp, Re, Hh^Fp, Hh^Fp, Gs^Fp, Gs^Fdw, Re, Re, Rr^Vhc, Gs^Fp, Hh^Fp
Ds, Ds, Ds, Ds, Wwf, Ww, Ww, Ww, Ww, Ww, Wwr, Ww, Ww, Ds, Re, Ds, Gs, Gs, Gg, Gg, Gs, Gd^Gvs, Gd^Gvs, Gd^Gvs, Gs, Gs, Gs, Gg, Gg, Rr, Ch, Ch, Ch, Rr, Rr^Vhc, Gs, Gg, Re, Gs, Gs, Hh, Gs^Fp, Gs^Fp, Gs^Fdw, Re, Re, Re, Hh^Fp
Ww, Ww^Ewl, Ww, Ww, Ww, Wwf, Ds, Ds, Ds, Ww, Ww, Ww, Ds, Re, Gs, Gs, Gg, Rr^Vhc, Gg, Gg^Efm, Gg, Gs, Gs, Gs, Gd^Gvs, Gd^Gvs, Gd^Gvs, Gs, Gs, Gg, Ch, 3 Kh, Ch, Gs, Gg, Gg, Ds, Gg, Gs, Gs^Fp, Gs^Fp, Gs^Fp, Gs^Fp, Hh^Fp, Hh^Fp, Gs, Re, Gs^Fp
Ww, Ww, Ds, Ww, Gg, Ds, Gs^Fp, Gs, Gs, Ds, Ds, Ww, Ds, Re, Gs, Gg, Hh, Gs^Fp, Gs, Gg, Gs, Gs, Gd^Gvs, Gd^Gvs, Gd^Gvs, Gd^Gvs, Gd^Gvs, Gd^Gvs, Gs, Gg, Rr^Vhc, Ch, Gs, Gs, Re, Ds, Wwr, Ds, Ds, Gs, Gs, Gs^Fp, Gs^Fp, Gs^Vh, Hh^Fp, Gg, Gs^Fp, Re
Ds, Ds, Gs, Gg, Hh^Fp, Gs^Fp, Gs^Fp, Gs^Fp, Hh, Gg, Ds, Ww, Ww, Ds, Gs, Gg, Gs^Fdw, Hh, Gs^Fp, Gg, Gs, Gd^Gvs, Gd^Gvs, Gd^Gvs, Gd^Gvs, Gd^Gvs, Gd^Gvs, Gd^Gvs, Gs, Gg, Gg, Gs, Re, Re, Ds, Ds, Ww, Ww, Ww, Ds, Gs, Gs, Gg, Hh, Hh, Hh, Hh, Gs^Fp
Gg, Gs^Fdw, Gs^Fdw, Hh, Hh, Hh, Gg^Ve, Gs^Fp, Gs^Fp, Hh, Re, Ww, Ww, Ds, Ds, Gs^Fdw, Gs^Fdw, Hh, Gs, Gs^Vh, Gs, Gd^Gvs, Gd^Gvs, Gd^Gvs, Gd^Gvs, Gd^Gvs, Gs, Gs, Gg, Gg, Ds, Ds, Wwf, Ds, Ww, Ww, Re, Ww^Ewl, Ww, Ds, Ds, Gg, Gg, Gg, Gs^Fp, Gs^Fp, Gs^Fp, Hh
Gs^Fdw, Aa, Gs^Fdw, Gs^Fp, Gs^Fp, Gs^Fp, Gs^Fdw, Hh^Em, Hh^Em, Hh, Gg, Re, Ww, Ww, Ds, Re, Gs, Gs^Fdw, Gg, Gg, Gg, Gs, Gs, Gd^Gvs, Gs, Gs, Gg, Gg, Gg, Gg, Ds, Wwf, Wwf^Es, Wwf, Re, Re, Gs, Re, Ds, Ww, Ww, Ds, Ds, Gg, Gg, Gs, Gs, Gs
Gs^Fdw, Gs^Fdw, Gs^Fdw, Gs^Fp, Gs^Fp, Aa, Gs^Fdw, Hh^Emf, Aa, Gs, Gs, Re, Re^Es, Ww, Ww, Re, Gs, Gs^Fdw, Gs^Fdw, Gg, Ds, Gg, Ww^Ewl, Gs, Ds, Gg, Ds, Gg, Ww, Ds, Ww, Ww, Re^Es, Re, Gs, Gs, Gg, Gs, Gs, Ds, Ds, Ww, Ww, Ds, Ds, Gg, Gg, Gg
Gs^Fdw, Gs^Fp, Gs^Fp, Gs^Fp, Aa, Aa, Gs^Fdw, Hh^Em, Gs^Fp, Aa, Gs^Fp, Aa, Re, Ds, Ww, Re, Re, Gs, Ds, Ds, Wwf, Ww, Ww, Ww^Ewl, Ww, Ds, Ww, Ww, Ww, Ww, Gg, Rr^Vhc, Re, Re^Es, Ch, Ch, Re, Gg, Gg, Gs, Gs, Ds, Ds, Ww, Ww, Ds, Ds, Gg
Gs^Fp, Gs^Fp, Hh^Fp, Hh^Fp, Gs, Gs^Fdw, Gs, Gs^Fp, Gs, Gs^Fp, Aa, Aa, Re, Ds, Ds, Ww, Ww, Ds, Wwr, Ww, Ww, Wwf, Re, Ww, Ww, Wwr, Ds, Ds, Ds, Gg, Gg, Re, Ch, Re, Rr, Rr, Rr, Re, Re, Gg, Gg, Gs, Gs, Ds, Gs, Ww, Ww, Ds
Gs^Fp, Gs^Fp, Hh^Fp, Hh^Fp, Gg, Gs^Fdw, Gg, Gs, Gg, Gg, Gg, Aa, Gs, Re, Re, Ds, Ds, Ww, Ww, Ww, Re, Re, Gs, Gs, Gs, Ds, Gg, Gg, Gs, Gs, Gs, Re, Ch, Rr, Ch, Ch, Ch, Rr, Rr^Vhc, Re, Re, Gg, Gg, Gs, Gg, Gs, Gs, Ww
Gs^Fp, Hh^Fp, Gg, Hh, Gs, Gg^Efm, Gg^Ve, Gg, Gs^Fdw, Gs, Gg, Gg^Efm, Aa, Gg, Gs, Re, Re, Ds, Ww, Ww^Ewl, Re, Gs, Gg, Gs, Gg, Gg, Gs, Gs, Gd^Gvs, Gd^Gvs, Gd^Gvs, Gs, Rr^Vhc, Rr, Ch, 2 Kh, Ch, Re, Gs, Rr, Rr, Re, Re, Gg, Gg^Efm, Gg, Gg, Gs
Hh^Fp, Hh^Fp, Re, Gg^Ve, Aa, Re, Ch, Gs^Fdw, Gs^Fdw, Gs, Gs^Fdw, Gg, Gg, Gg, Ds, Gs, Ds, Ds, Ww, Ww, Re^Es, Gs, Rr^Vhc, Gg, Gs, Gs, Gd^Gvs, Gd^Gvs, Gd^Gvs, Gd^Gvs, Gd^Gvs, Gd^Gvs, Rr^Vhc, Rr, Rr, Ch, Rr, Re, Gg, Gs, Gs, Rr^Vhc, Rr, Re^Es, Re^Es, Gg^Efm, Gg^Efm, Gg
Gg, Re, Ch, Ch, Ch, Rr, Ch, Gs^Fdw, Gs^Fdw, Gs, Gs, Gg, Gg^Efm, Gs, Wwf, Ds, Ww, Ww, Re, Re^Es, Gs, Gs, Gg, Gs, Gd^Gvs, Gd^Gvs, Gd^Gvs, Gd^Gvs, Gd^Gvs, Gd^Gvs, Gd^Gvs, Gd^Gvs, Gs, Ch, Ch, Rr, Ch, Gg, Gs, Gs, Gd^Gvs, Gs, Gs, Rr, Rr, Re, Re, Gg^Efm
Gs, Re^Es, Ch, 4 Kh, Ch, Rr, Ch, Gs^Fdw, Gs^Fdw, Gs^Fdw, Gs, Gg, Ds, Ww, Ww, Wwf, Ds, Re, Gs, Gs, Hh^Em, Hh^Em, Gg, Gs, Gd^Gvs, Gd^Gvs, Gd^Gvs, Gd^Gvs, Gd^Gvs, Gd^Gvs, Gs, Gs, Gd^Gvs, Gs, Gs, Ch, Gs, Gs, Gd^Gvs, Gd^Gvs, Gd^Gvs, Gd^Gvs, Gs, Gs, Gs, Rr, Rr, Re
Aa, Re, Re, Ch, Re^Es, Rr, Re^Es, Gs^Fdw, Gs^Fdw, Gs, Hh, Gg, Ds, Ww^Ewl, Ds, Ds, Gs, Gs, Gg, Gg, Hh^Em, Hh^Emf, Hh^Em, Gs, Gs, Gd^Gvs, Gd^Gvs, Gd^Gvs, Gs, Gs, Gd^Gvs, Gd^Gvs, Gd^Gvs, Gd^Gvs, Gs, Rr^Vhc, Gs, Gd^Gvs, Gd^Gvs, Gd^Gvs, Gd^Gvs, Gd^Gvs, Gs, Gg^Efm, Gg, Gs, Gs, Rr
Aa, Aa, Gs, Gs^Fdw, Gs^Fdw, Re, Gs^Fdw, Hh^Fdw, Hh, Hh, Gg, Gg, Ds, Ww, Ds, Gs, Gg, Gs^Fp, Hh, Hh^Fp, Hh, Hh^Em, Gs^Fdw, Hh, Hh, Gs, Gs, Gs, Gg, Gs, Gd^Gvs, Gd^Gvs, Gd^Gvs, Gd^Gvs, Gs, Gg, Gs, Gd^Gvs, Gd^Gvs, Gd^Gvs, Gs, Gs, Gg, Gg, Hh, Gg, Gg, Gs
Aa, Aa, Gs, Gg, Gg, Hh^Fdw, Hh, Hh, Hh, Hh, Gg, Gg, Ds, Ww, Ds, Gs, Hh, Hh, Hh, Hh^Fp, Gs^Fp, Gs^Fp, Gs^Fp, Gs^Fdw, Gs^Fdw, Hh, Hh, Hh, Gg, Gs, Gs, Gd^Gvs, Gs, Gs, Gg, Gg, Gg, Gs, Gs, Gs, Gg, Gg, Hh, Hh, Hh, Hh, Hh, Gg
