Gs^Fp, Gs^Fp, Gs^Fp, Gs^Fp, Gs^Fp, Gs^Fp, Gs, Gd, Gg^Efm, Gs^Fp, Gs^Fp, Gs^Fp, Gs^Fp, Gs^Fp, Gs^Fp, Gd, Gd, Gs^Fp, Gs, Gd, Gs, Gs, Gs^Fp, Gs^Fp, Gs^Fp, Gs^Fp, Gs^Fp, Gs^Fp, Gs^Fp, Ww, Wwf, Wwf, Gs^Fp, Gs^Fp, Gg, Gg, Ww, Ww, Ww^Ewl, Ww, Wwf, Ww, Ww, Gs^Fp, Gs^Fp, Gs^Fp, Gs, Gs
Gs^Fp, Gs^Fp, Gs^Fp, Gd, Gd, Gs, Gg^Efm, Gs^Efm, Gs^Fp, Gs^Fp, Gg^Ve, Gs^Fp, Gs^Fp, Gs, Gs^Em, Gd^Em, Co, Co, Co, Gd, Gg, Gd^Vo, Ww^Ewl, Ww^Ewl, Ds, Gs^Fp, Wwf, Ww, Wwr, Wwf, Gs^Fp, Gs^Fp, Gs^Fp, Gs^Fp, Gs^Fp, Gs^Fp, Gs^Fp, Gg, Gg, Wwf, Gs^Fp, Wwf, Ww^Ewl, Gs^Fp, Gs^Fp, Gs, Gd, Gs
Gs^Fp, Gs^Fp, Gs^Fp, Gs^Fp, Gs^Fp, Gs^Fp, Gg, Gs^Fp, Gs^Fp, Gs^Fp, Gs^Fp, Gs^Fp, Gs^Fp, Gs, Gs^Em, Gd^Emf, Co, 2 Ko, Co, Gd^Em, Ww, Ww, Wwf, Ds, Wwf, Wwf, Ds, Ds, Ds, Gs^Fp, Gs, Gs, Gs^Fp, Gg^Efm, Gg^Efm, Gg^Efm, Gg, Gs^Fp, Gd, Gg^Efm, Gs^Fp, Ww^Wkf, Re, Gs^Fp, Gs, Gs^Efm, Gs^Efm, Gs
Gs^Fp, Gs^Fp, Gs^Fp, Gs^Fp, Gg, Gs^Fp, Gs^Fp, Gs^Fp, Gs, Gs^Fp, Gs^Fp, Gs^Fp, Gs^Fp, Gs^Fp, Gd^Vo, Gd^Em, Gd, Co, Ww, Gd, Wwf, Wwf, Ds, Wwf, Ds, Ds, Ww, Gg^Efm, Gs^Fp, Gs^Fp, Gs, Gs^Fp, Gg, Gg, Gs^Fp, Gg^Efm, Gg^Efm, Gg, Gd, Gs, Gs, Re, Gs, Gll, Gll, Gs^Fp, Gs^Fp, Gs^Fp
Gs, Gs^Efm, Gs^Efm, Gs^Fp, Gs^Efm, Gg^Efm, Gs^Fp, Gs^Fp, Gs, Gs^Fp, Gs, Gs^Fp, Gs^Efm, Gs^Fp, Gs^Fp, Gs, Gg, Wwf, Ds, Gg, Wwr, Ds, Ww, Ww^Ewl, Ww^Ewf, Ww, Wwf, Wwf, Wwf, Gs^Fp, Gs, Gg, Gg^Efm, Gg, Gs^Fp, Gs^Fp, Gg, Gd, Gs, Gs^Fp, Gs, Re, Gs, Ss, Ss, Gll, Gll, Gs^Fp
Gs^Fp, Gs^Fp, Gs^Fp, Gs^Efm, Gs^Fp, Gs^Fp, Gs^Fp, Gs^Fp, Gs^Fp, Gs, Gg^Efm, Gs, Gg^Efm, Gs^Fp, Gs^Fp, Gg, Wwf, Wwf, Wwf, Ds, Wwr, Wwr, Gs, Ww^Ewl, Gll, Wwf, Gll^Emf, Gll^Em, Gs, Gs, Gs^Fp, Gs^Fp, Gg, Gs^Fp, Gg, Gg, Gs^Fp, Gs^Fp, Gg, Gg^Efm, Gg, Gs, Gg, Ss, Wwr, Ss, Gll, Gs^Fp
Gs^Fp, Gg^Ve, Gs^Fp, Gs^Fp, Gs^Fp, Gs^Fp, Gs^Fp, Gs^Fp, Gs^Fp, Gs^Fp, Gg^Efm, Gs^Fp, Gs^Fp, Gs^Fp, Gs^Fp, Gd^Es, Gd, Ds, Wwf, Wwf, Gs, Gd^Vhr, Gg, Gg, Gg, Gll^Em, Gg^Efm, Gg, Gs^Fp, Gs^Fp, Rb, Gs^Fp, Gs^Fp, Gg, Gs^Fp, Gs, Gs^Fp, Re, Gg^Efm, Gg^Efm, Gs^Fp, Gs, Re, Gg^Efm, Wwf, Ss, Gll, Gs^Fp
Gs^Fp, Gs^Fp, Gs^Fp, Gs^Fp, Gs^Fp, Gs^Fp, Gs^Fp, Gs^Fp, Gs^Fp, Gg^Efm, Gg^Efm, Gs^Fp, Gs^Fp, Gs^Fp, Gs^Fp, Gs^Fp, Gs^Fp, Ds, Ds, Ds, Ds, Gg^Efm, Gg^Efm, Gg, Gs, Gg^Efm, Gg^Efm, Gs^Fp, Gs^Fp, Rb, Gs^Fp, Rb^Es, Rb, Gs^Fp, Gs^Fp, Gs^Fp, Gg^Ve, Gs^Fp, Gs, Gs^Fp, Gs^Fp, Re, Gg, Wwf, Ss, Ss, Gll, Gs^Fp
Gs^Fp, Gs^Fp, Gs^Efm, Gs, Gs^Fp, Gs^Fp, Gs^Fp, Gs^Fp, Gs^Fp, Wwf, Wwf, Gs^Fp, Wwf, Gs^Fp, Gs^Fp, Gs^Fp, Ww^Ewl, Ds, Wwf, Gll^Em, Gg, Re, Re, Re, Gs, Gs^Fp, Gs^Fp, Gs^Fp, Gs^Fp, Gs^Fp, Gs^Fet, Gs^Fp, Gs^Fp, Gs^Fp, Gs^Fp, Gs^Fp, Gs^Fp, Gs^Fp, Gs^Fp, Gs, Gs, Re, Gg^Efm, Ww^Wkf, Ss, Ss, Gll^Em, Gg
Gs^Fp, Gs^Fp, Gs, Gs^Fp, Gs^Fp, Gs^Fp, Gs^Fp, Gs^Fp, Gd, Gd^Es, Gs, Wwf, Gs, Ww, Wwf, Ww, Ds, Wwf, Gll^Em, Gll^Emf, Gs, Gs^Efm, Gs^Efm, Gs^Fp, Gs^Efm, Gs^Fp, Gg^Ve, Gs^Fp, Gs^Fp, Gs^Fp, Gs^Fp, Gs^Fp, Gs^Fp, Gs^Fp, Gs, Gs, Gs, Gs^Fp, Gd^Em, Gd^Em, Gg^Efm, Gg, Gg^Efm, Ss, Gll, Ss, Gll^Emf, Gg
Gs, Gs, Gs^Fp, Gs^Fp, Gs^Fp, Gs^Fp, Gs^Fp, Gs^Fp, Gs^Fp, Gs^Fp, Gs^Fp, Gs, Gg, Ds, Ds, Ds, Gg^Efm, Ds, Gg, Gs, Gd, Gs^Fp, Gs^Fp, Gs^Efm, Gs^Fp, Gs, Gs^Fp, Gs^Fp, Rb, Gs^Fp, Gs^Fp, Gs^Fp, Gs^Fp, Gs^Fp, Gs^Fp, Gs^Fp, Gs^Fp, Gs, Gg, Gg, Gs^Ecf, Gg, Ss, Ss^Vhs, Gg, Gll^Em, Gs^Fp, Gs^Fp
Wwf, Gs^Fp, Wwf, Gs^Fp, Ww, Wwr, Wwf, Gs^Fp, Ww, Wwr, Wwf, Wwf, Wwf, Gg, Wwr, Ww^Ewl, Gg, Gg, Gs^Vh, Gs, Gd, Gs^Fp, Gs^Fp, Gs^Fp, Rb^Es, Rb, Gs^Fp, Gs^Fp, Gg, Rb, Gs^Fp, Rb, Gs^Fp, Gs^Fp, Gs^Fp, Gs^Fp, Gll, Gll, Gll, Gs, Gll, Gll, Ss, Ss, Ss, Gg, Gg^Efm, Gg
Gg, Wwf, Gg, Ww^Ewl, Gs^Fp, Gs^Fp, Gg^Efm, Wwf, Wwf, Gg, Ds, Ds, Ds, Ds, Ww^Ewl, Re, Re, Gg^Efm, Gg, Gs, Gs^Efm, Gs^Fp, Gs^Fp, Rb, Gs^Fp, Gs^Fp, Gg, Gs^Fp, Gs^Fp, Rb, Rb^Es, Rb, Gs^Fp, Gs^Fp, Gs^Fp, Gll, Ss, Ss, Ss^Vhs, Gll, Chs, Ss, Chs, Sm, Ss, Gg, Gg, Gg
Gg, Gs^Efm, Gd, Gs^Efm, Gs, Gs^Fp, Gs^Fp, Gg^Efm, Ds, Gg, Wwf, Wwf, Ww, Ww^Ewl, Gg, Gs^Fp, Gg, Gg, Gs^Fp, Gs^Fp, Gg, Gs, Gs, Rb, Gs^Fp, Gg, Re, Re, Gs^Fp, Gs^Fp, Gs, Gs^Fp, Gd^Es, Gs^Fp, Gs^Fp, Gll, Ss, Ss, Chs, Ss, Chs, 3 Khs, Wwf, Chs, Ss, Gg, Ss, Ss
Gs^Fp, Gs^Fp, Gs^Fp, Gs^Fp, Gs^Es, Wwr, Ds, Ds, Wwf, Ds, Wwf, Wwf, Gll^Em, Gg^Efm, Gs^Fp, Gs, Gs, Gs, Gs, Gs, Gs, Gs^Fp, Gg, Gs, Gs, Gs, Gs^Fp, Gs^Fp, Gg, Gs^Fp, Gs, Gs^Fp, Gd^Es, Gs^Fp, Ww, Gs^Fp, Ss, Sm, Sm, Chs, Wwf, Chs, Ww^Wkf, Ss, Ss, Ss, Ww^Wkf, Ss
Gs^Fp, Re, Gs^Fp, Gs^Fp, Gd, Gg^Efm, Ds, Wwf, Ww, Wwf, Gll^Em, Gll^Emf, Gg^Efm, Gg^Efm, Gs, Gs^Fp, Gs^Fp, Gg^Efm, Rb, Rb, Gs^Fp, Gs^Fp, Gs^Fp, Gs^Fp, Gs^Fp, Gs^Fp, Gs, Gs, Gs^Fp, Gg^Efm, Gs, Gd^Es, Gs, Gs^Fp, Gs^Fp, Gs^Fp, Ss, Ss, Ss, Ss, Wwf, Gll, Ww^Wkf, Ss, Wwf, Wwf, Gll, Ss
Re, Gs^Fp, Re, Re, Gs^Fp, Gs, Gs, Ds, Gs, Ww, Gg, Gg, Gs, Gd, Re, Gg, Gg^Em, Gs^Fp, Gs^Fp, Gg^Ve, Gs^Fp, Gs^Fp, Gs^Fp, Gg^Efm, Gs^Fp, Gs, Gs^Fp, Gs^Fp, Gg^Efm, Gg^Efm, Gg, Gs, Gs^Fp, Gs^Fp, Ss, Ss^Vhs, Ss, Wwr, Wwf, Wwf, Gg^Efm, Gll^Em, Gll^Emf, Ww^Wkf, Gll, Gll^Efm, Gg^Efm, Gll
Gs, Re, Gs^Fp, Gs^Fp, Gs, Gs^Fp, Gs^Fp, Gs^Fp, Gs, Gg, Gg^Efm, Re, Gs^Fp, Gs^Es, Re, Gd^Emf, Gs^Em, Gs^Fp, Gs^Fp, Gs^Fp, Gs, Gs^Fp, Gs^Fp, Gg, Gs^Efm, Gs, Gg^Efm, Gg, Gd^Vhr, Gg, Wwf, Wwf, Ww^Ewl, Gs^Fp, Gs^Fp, Gs^Fp, Gs^Fp, Gs^Fp, Gs^Fp, Gg, Gg^Efm, Gg, Gg, Gll^Em, Gs^Fp, Gg, Gs^Fp, Gg
Gs^Fp, Gs^Fp, Gs^Fp, Gs, Gs^Fp, Gd^Vhr, Gg, Gg, Cvr, Gg^Efm, Gs^Fp, Gs^Fp, Gs^Fp, Gs^Fp, Re, Gs^Em, Gs^Fp, Gs, Gs^Fp, Gs^Fp, Gs, Gs^Fp, Gs^Fp, Gg, Gg^Efm, Gg^Efm, Gll, Gg, Gs, Gs, Wwf, Wwr, Gs^Fp, Gs^Fp, Gs^Fp, Gs^Fp, Gs^Fp, Gs^Fp, Gs^Fp, Gg, Gg, Gg^Efm, Gg, Gs, Gs, Gs^Fp, Gs^Fp, Gs^Fp
Gs^Fp, Gs^Fp, Gs^Fp, Gs, Gg, Gg^Efm, Gg^Efm, Cvr, 1 Kvr, Cvr, Gs^Fp, Gs^Fp, Gs^Fp, Re, Gg^Es, Gs^Fp, Gg, Gg^Ve, Gs^Es, Gs, Gs^Fp, Gg, Gg^Efm, Gg^Efm, Gg, Wwf, Wwf, Gll, Gs, Wwf, Ww^Ewl, Ww, Gs^Fp, Gs^Fp, Gs^Fp, Gg, Gg, Gs^Fp, Gg, Gs^Fp, Gs^Fp, Gs^Fp, Gs^Fp, Gs, Gs^Efm, Gs^Fp, Gs, Gs^Fp
Gs^Fp, Gs^Fp, Gs^Fp, Re, Gs^Es, Re, Gs^Efm, Cvr, Cvr, Cvr, Gs^Fp, Gs^Fp, Gs^Fp, Gs, Gg, Gg, Gg^Efm, Gs^Fp, Gs^Fp, Gs, Gg, Gg^Efm, Gg, Gs^Efm, Gs, Ww, Wwf, Ww, Wwr, Ww^Ewl, Gs^Fp, Gs^Fp, Gs^Fp, Gs^Fp, Gs^Fp, Gs^Fp, Gg, Gg^Ve, Gs^Fp, Gs^Fp, Gs^Fp, Gs^Fp, Gg^Efm, Gg^Efm, Gs^Efm, Gs, Gs^Fp, Gs^Efm
Gs^Fp, Gs^Fp, Gs, Gs^Fp, Gs, Re, Re, Gg^Efm, Gg^Efm, Gs^Fp, Gs^Fp, Gs^Fp, Gs^Fp, Gs^Fp, Gs^Fp, Gg, Gg, Gg, Gg, Gg^Efm, Gg, Gg, Wwf, Gg^Efm, Gg, Gs, Wwf, Gg, Gg^Efm, Gs^Fp, Gs^Fp, Gg^Efm, Gs^Fp, Gs^Fp, Gs^Fp, Gs^Fp, Gg, Gg, Gs^Fp, Gs^Fp, Gs, Gs, Gs, Gs^Fp, Gs^Fp, Gs^Fp, Gs^Fp, Gs^Fp
