Gs^Fp, Gs^Fp, Gs^Fp, Gs^Fp, Gs^Fp, Gs^Fp, Gs, Gs, Gg, Gs^Fp, Gs^Fp, Gs^Fp, Gs^Fp, Gs^Fp, Gs^Fp, Gd, Gd, Gs^Fp, Co^Edt, Gd, Gs, Gs, Gg, Gg, Gg, Gg, Gg, Gg, Gg, Ww, Wwf, Wwf, Gs^Fp, Gs^Fp, Gg, Gg, Ww, Ww, Ww^Ewl, Ww, Wwf, Ww, Ww, Gg, Gs^Fp, Gs^Fp, Gs, Gs
Gs^Fp, Gg, Gg, Gs, Gs, Gs, Gg, Gs, Gs^Fp, Gs^Fp, Gg^Ve, Gs^Fp, Gs^Fp, Gs, Gs, Gd, Co, Co, Co, Gd, Gg, Gd^Vo, Ww^Ewl, Ww^Ewl, Gg, Wwf, Wwf, Ww, Wwr, Wwf, Gg, Gg, Gs^Fp, Gs^Fp, Gs^Fp, Gs^Fp, Gs^Fp, Gg, Gg, Wwf, Gg, Wwf, Ww^Ewl, Gg, Gg, Gs, Gs, Gs
Gg, Gg, Gs^Fp, Gs^Fp, Gs^Fp, Gs^Fp, Gg, Gs^Fp, Gs^Fp, Gs^Fp, Gs^Fp, Gs^Fp, Gs^Fp, Gs, Gs, Gd^Edt, Co^Edt, 2 Ko, Co^Edt, Gd^Edt, Ww, Ww, Wwf, Gg, Wwf, Wwf, Gg, Gg, Gg, Gg, Gs, Gs, Gs^Fp, Gg, Gg, Gg, Gg, Gs^Fp, Gg, Gg^Efm, Gg, Wwf^Wkf, Gg, Gg, Gg, Gs, Gs, Gs
Gg, Gs^Fp, Gs^Fp, Gs^Fp, Gg, Gs^Fp, Gs^Fp, Gs^Fp, Gs, Gs^Fp, Gs^Fp, Gs^Fp, Gs^Fp, Gs^Fp, Gd^Vo, Gd, Gd^Edt, Co^Edt, Ww, Gd, Wwf, Wwf, Gg, Wwf, Gg, Gg, Ww, Gg^Efm, Gg, Gg, Gs, Gs^Fp, Gg, Gg, Gs^Fp, Gg, Gg^Efm, Gg, Gs, Gs, Gs, Gg, Gs, Gll, Gll, Gg, Gg, Gg
Gs, Gs, Gs, Gs^Fp, Gs, Gg^Efm, Gs^Fp, Gg, Gs, Gs^Fp, Gs, Gs^Fp, Gs, Gs^Fp, Gs^Fp, Gs, Gg, Wwf, Gg, Gg, Wwr, Gg, Ww, Ww^Ewl, Ww^Ewf, Ww, Wwf, Wwf, Wwf, Gg, Gs, Gg, Gg, Gg, Gs^Fp, Gs^Fp, Gg, Gg, Gs, Gs^Fp, Gs, Gs^Fp, Gs, Ss, Ss, Gll, Gll, Gg
Gs^Fp, Gs^Fp, Gs^Fp, Gs, Gs^Fp, Gg, Gg, Gg, Gg, Gs, Gg^Efm, Gs, Gg, Gs^Fp, Gs^Fp, Gg, Wwf, Wwf, Wwf, Gg, Wwr, Wwr, Gs, Ww^Ewl, Gg, Wwf, Gg, Gg, Gs, Gs, Gs^Fp, Gs^Fp, Gg, Gs^Fp, Gg, Gg, Gs^Fp, Gs^Fp, Gg, Gg^Efm, Gg, Gs, Gg, Ss, Wwr, Ss, Gll, Gs^Fp
Gs^Fp, Gg^Ve, Gs^Fp, Gs^Fp, Gg, Gg, Gs^Fp, Gg, Gg, Gs^Fp, Gg^Efm, Gs^Fp, Gs^Fp, Gs^Fp, Gg, Gd, Gd, Gs^Es, Wwf, Wwf, Gs, Gd^Vhr, Gg, Gg, Gg, Gg, Gg, Gg, Gs^Fp, Gs^Fp, Rb, Gs^Fp, Gs^Fp, Gg, Gs^Fp, Gs, Gs^Fp, Gg, Gg, Gg, Gs^Fp, Gs, Gg, Gg, Wwf, Ss, Gll, Gs^Fp
Gs^Fp, Gs^Fp, Gs^Fp, Gg, Gs^Fp, Gs^Fp, Gg, Gg, Gg, Gg^Efm, Gg^Efm, Gg, Gg, Gs^Fp, Gg, Gg, Gg, Gs, Gs, Gs, Gg, Gg^Efm, Gg^Efm, Gg, Gs, Gg, Gg, Gs^Fp, Gs^Fp, Rb, Gs^Fp, Rb^Es, Rb, Gs^Fp, Gs^Fp, Gs^Fp, Gg^Ve, Gs^Fp, Gs, Gs^Fp, Gs^Fp, Gs^Es, Gg, Wwf^Wkf, Ss, Ss, Gll, Gs^Fp
Gs^Fp, Gs^Fp, Gs, Gs, Gs^Fp, Gs^Fp, Gs^Fp, Gs^Fp, Gg, Wwf, Wwf, Gg, Wwf, Gg, Gg, Gg, Ww^Ewl, Wwf, Wwf, Gg, Gg, Gg, Gg, Gg, Gs, Gs^Fp, Gs^Fp, Gs^Fp, Gs^Fp, Gs^Fp, Gs^Fet, Gs^Fp, Gs^Fp, Gs^Fp, Gs^Fp, Gs^Fp, Gs^Fp, Gs^Fp, Gs^Fp, Gs, Gs, Gs, Gg, Ww^Wkf, Ss, Ss, Gll^Em, Gg
Gs^Fp, Gs^Fp, Gs, Gs^Fp, Gg, Gs^Fp, Gs^Fp, Gs^Fp, Gs, Gs, Gs, Wwf, Gs, Ww, Wwf, Ww, Gg, Wwf, Gg, Gg, Gs, Gs, Gs, Gs^Fp, Gs, Gs^Fp, Gg^Ve, Gs^Fp, Gs^Fp, Gs^Fp, Gs^Fp, Gs^Fp, Gs^Fp, Gs^Fp, Gs, Gs, Gs, Gs^Fp, Gg, Gg, Gg, Gg, Gg^Efm, Ss, Gll, Ss, Gll^Emf, Gg
Gs, Gs, Gg, Gg, Gg, Gg, Gg, Gg, Gg, Gg, Gg, Gs, Gg, Gg, Gg, Gg, Gg^Efm, Gg, Gg, Gg, Gs, Gs^Fp, Gs^Fp, Gs, Gs^Fp, Gs, Gs^Fp, Gs^Fp, Rb, Gs^Fp, Gs^Fp, Gs^Fp, Gs^Fp, Gs^Fp, Gs^Fp, Gg, Gg, Gs, Gg, Gg, Gs^Ecf, Gg, Ss, Ss^Vhs, Gg, Gll^Em, Gs^Fp, Gs^Fp
Wwf, Gg, Wwf, Gg, Ww, Wwr, Wwf, Gg, Ww, Wwr, Wwf, Wwf, Wwf, Gg, Wwr, Ww^Ewl, Gg, Gg, Gs^Vh, Gg, Gs, Gs^Fp, Gs^Fp, Gs^Fp, Rb^Es, Rb, Gs^Fp, Gs^Fp, Gg, Rb, Gs^Fp, Rb, Gs^Fp, Gg, Gg, Gg, Gll, Gll, Gll, Gs, Gll, Gll, Ss, Ss, Ss, Gg, Gg^Efm, Gg
Gg, Wwf, Gg, Ww^Ewl, Gg, Gg, Gg^Efm, Wwf, Wwf, Gg, Gg, Gg, Gg, Gg, Ww^Ewl, Gg, Gg, Gg^Efm, Gg, Gg, Gs, Gs^Fp, Gs^Fp, Rb, Gs^Fp, Gs^Fp, Gg, Gs^Fp, Gs^Fp, Rb, Rb^Es, Rb, Gs^Fp, Gg, Gg, Gll, Ss, Ss, Ss^Vhs, Gll, Chs, Ss, Chs, Sm, Ss, Gg, Gg, Gg
Gg, Gs, Gs, Gs, Gs, Gg, Gg, Gg^Efm, Gg, Gg, Wwf, Wwf, Ww, Ww^Ewl, Gg, Gs^Fp, Gg, Gg, Gs^Fp, Gs^Fp, Gg, Gs, Gs, Rb, Gs^Fp, Gg, Gs, Gg, Gs^Fp, Gs^Fp, Gg, Gs^Fp, Gg, Gg, Gg, Gll, Ss, Ss, Chs, Ss, Chs, 3 Khs, Wwf, Chs, Ss, Gg, Ss, Ss
Gs^Fp, Gs^Fp, Gs^Fp, Gs^Fp, Gs^Es, Wwr, Gg, Gg, Wwf, Gg, Wwf, Wwf, Gg, Gg, Gs^Fp, Gg, Gg, Gg, Gg, Gg, Gs^Fp, Gs^Fp, Gg, Gs, Gs, Gs, Gs^Fp, Gs^Fp, Gg, Gs^Fp, Gg, Gs^Fp, Gg, Gg, Ww, Gg, Ss, Sm, Sm, Chs, Wwf, Chs, Wwf^Wkf, Ss, Ss, Ss, Ww^Wkf, Ss
Gs^Fp, Gs, Gs^Fp, Gs^Fp, Gs, Gg, Gg, Wwf, Ww, Wwf, Gg, Gg, Gg, Gg, Gg, Gs^Fp, Gs^Fp, Gg^Efm, Rb, Rb, Gs^Fp, Gs^Fp, Gs^Fp, Gs^Fp, Gs^Fp, Gs^Fp, Gs, Gs, Gs^Fp, Gg, Gg, Gg, Gg, Gg, Gg, Gg, Ss, Ss, Ss, Ss, Wwf^Wkf, Gll, Ww^Wkf, Ss, Wwf, Wwf, Gll, Ss
Gs^Fp, Gs^Fp, Gs, Gs, Gs^Fp, Gs, Gs, Gs, Gs, Ww, Gg, Gg, Gs, Gg, Gs, Gg, Gg, Gs^Fp, Gs^Fp, Gg^Ve, Gs^Fp, Gs^Fp, Gs^Fp, Gg, Gs^Fp, Gs, Gs^Fp, Gs^Fp, Gg, Gg, Gg, Gg, Gg, Gg, Ss, Ss^Vhs, Ss, Wwr, Wwf^Wkf, Wwf, Gg, Gll^Em, Gll^Emf, Wwf^Wkf, Gll, Gll, Gg, Gll
Gs, Gs, Gs^Fp, Gs^Fp, Gs, Gs^Fp, Gs^Fp, Gs^Fp, Gs, Gg, Gg, Gg, Gs^Fp, Gs^Es, Gs, Gs, Gs, Gs^Fp, Gs^Fp, Gs^Fp, Gs, Gs^Fp, Gs^Fp, Gg, Gs, Gs, Gg, Gg, Gd^Vhr, Gg, Wwf, Wwf, Ww^Ewl, Gg, Gg, Gg, Gg, Gg, Gs^Fp, Gg, Gg^Efm, Gg, Gg, Gll^Em, Gs^Fp, Gg, Gs^Fp, Gg
Gg, Gg, Gs^Fp, Gs, Gs^Fp, Gd^Vhr, Gg, Gg, Gg, Gg, Gs^Fp, Gs^Fp, Gs^Fp, Gs^Fp, Gs, Gs, Gs^Fp, Gs, Gs^Fp, Gs^Fp, Gs, Gs^Fp, Gs^Fp, Gg, Gg, Gg, Gg, Gg, Gs, Gs, Wwf, Wwr, Gg, Gg, Gs^Fp, Gs^Fp, Gs^Fp, Gs^Fp, Gs^Fp, Gg, Gg, Gg^Efm, Gg, Gs, Gs, Gs^Fp, Gs^Fp, Gs^Fp
Gs^Fp, Gg, Gs^Fp, Gs, Gg, Gg, Gg, Gg^Efm, Gg^Efm, Gg, Gg, Gg, Gs^Fp, Gs, Gg, Gs^Fp, Gg, Gg^Ve, Gs, Gs, Gs^Fp, Gg, Gg, Gg, Gg, Wwf, Wwf, Gg, Gs, Wwf, Ww^Ewl, Ww, Gg, Gs^Fp, Gs^Fp, Gg, Gg, Gs^Fp, Gg, Gs^Fp, Gs^Fp, Gs^Fp, Gs^Fp, Gs, Gs, Gs^Fp, Gs, Gs^Fp
Gs^Fp, Gg, Gg, Gs, Gs^Es, Gg, Gg, Gg^Efm, Gg, Gg^Efm, Gg, Gg, Gs^Fp, Gs, Gg, Gg, Gg^Efm, Gs^Fp, Gs^Fp, Gs, Gg, Gg, Gg, Gs, Gs, Ww, Wwf, Ww, Wwr, Ww^Ewl, Gg, Gg, Gs^Fp, Gs^Fp, Gs^Fp, Gs^Fp, Gg, Gg^Ve, Gs^Fp, Gs^Fp, Gs^Fp, Gs^Fp, Gg, Gg, Gs, Gs, Gs^Fp, Gs
Gg, Gg, Gg^Edb, Gg, Gg^Edb, Gs, Gs, Gg, Gg^Efm, Gg, Gs^Fp, Gg, Gg, Gs^Fp, Gs^Fp, Gg, Gg, Gg, Gg, Gg, Gg, Gg, Wwf, Gg, Gg, Gs, Wwf, Gg, Gg^Efm, Gg, Gg, Gg^Efm, Gs^Fp, Gs^Fp, Gs^Fp, Gs^Fp, Gg, Gg, Gs^Fp, Gs^Fp, Gs, Gs, Gs, Gs^Fp, Gs^Fp, Gs^Fp, Gs^Fp, Gs^Fp
Gs^Fp, Gg^Edb, Cvr, Cvr^Edb, Cvr^Edb, Gg, Gg, Gg, Gg, Gg, Gg, Gg, Gs^Fp, Gs^Fp, Gg, Gs^Fp, Gg, Wwr, Ww^Ewf, Wwf, Wwf, Wwf, Gg, Gg, Gg, Gs, Gg, Gg, Gg, Gg, Gg, Gs^Fp, Gg, Gg, Gg, Gg, Gs^Fp, Gs^Fp, Gs^Fp, Gs^Fp, Gs^Fp, Gs^Fp, Gs, Gs^Fp, Gs^Fp, Gs^Fp, Gs^Fp, Gs^Fp
Gs^Fp, Gg, Cvr, 1 Kvr, Cvr, Gs, Gs^Fp, Gg, Gs, Gs, Gs, Gg, Gg, Gg, Gg, Gg, Gg, Gg, Gs, Ww^Ewl, Gs, Ww, Gg, Gg^Efm, Gg, Gg, Gs^Fp, Gg, Gs^Fp, Gs^Fp, Gs^Fp, Gg, Gs^Fp, Gs^Fp, Gs^Fp, Gs^Fp, Gs^Fp, Gs^Fp, Gs^Fp, Gs^Fp, Gs^Fp, Gs^Fp, Gs, Gs^Fp, Gs^Fp, Gs^Fp, Gs^Fp, Gs^Fp
Gs^Fp, Gg, Gs, Cvr^Edb, Gs^Edb, Gs, Gs^Fp, Gs^Fp, Gs^Fp, Gs^Fp, Gs^Fp, Gs, Gg, Gg, Gs^Fp, Gs^Fp, Gg, Gs, Gg, Gs, Ww, Gg, Ww, Gg, Gg, Gs^Fp, Gg, Gg, Gs^Fp, Gs^Fp, Gs^Fp, Gs^Fp, Gs^Fp, Gs^Fp, Gs^Fp, Gg, Gg, Gs^Fp, Gg, Gs^Fp, Gs, Gs, Gg, Gs^Fp, Gg^Efm, Gg, Gg, Gg
Gs^Fp, Gs^Fp, Gs^Fp, Gs, Gg, Gs, Gg, Gg, Gg, Gs^Fp, Gg, Gs, Gs^Fp, Gs^Fp, Gs^Fp, Gs^Fp, Gs^Fp, Gg, Ww, Ww, Gg, Ww, Ww, Gg, Gg, Gg, Gg, Gs^Fp, Gs^Fp, Gs^Fp, Gs^Fp, Gs^Fp, Gs^Fp, Gs^Fp, Gs^Fp, Gs^Fp, Gs^Fp, Gs^Fp, Gs^Fp, Gg, Gs, Gg, Gs^Fp, Gg, Gs^Fp, Gs^Fp, Gs^Fp, Gs^Fp
