Hhd, Hhd, Hh^Fmw, Hh^Fmw, Re^Fmw, Hh, Hhd, Hh, Hhd, Hh, Mm, Hh, Hh, Hh, Mm, Hh, Hhd, Hh, Mm, Mm, Mm, Aa, Aa, Aa, Aa, Aa, Aa, Aa, Aa, Aa, Aa, Aa
Hh, Hh^Fp, Re, Re, Re^Es, Hhd, Re^Fp, Hhd^Fmw, Hh^Fmw, Mm, Mm, Mm, Mm, Mm, Mm, Mm, Mm, Mm, Mm, Mm, Mm, Mm, Mm, Aa, Aa, Aa, Re, Re, Re^Efm, Aa, Aa, Aa
Hh, Re^Es, Cv, Cv, Cv, Re^Es, Re, Re, Re, Mm, Mm, Mm, Mm, Mm, Aa, Mm, Mm, Mm, Aa, Mm, Aa, Mm, Aa, Aa, Aa, Re, Ch, Ch, Ch, Re^Efm, Aa, Aa
Re^Fdw, Re, Cv, 2 Kv, Cv, Re^Fdw, Re, Aa, Aa, Re^Fdw, Re^Fdw, Mm, Mm, Mm, Mm, Aa, Aa, Mm, Mm, Aa, Aa, Aa, Re^Es, Re^Es, Re, Re, Ch, 3 Kh, Ch, Re^Efm, Aa, Aa
Gg, Gs, Gg^Efm, Cv, Gs^Fdw, Gd^Fmw, Aa, Aa^Fdw, Aa, Aa, Re, Mm, Mm, Mm, Mm, Mm, Mm, Aa, Aa, Mm, Aa, Aa, Re, Re^Es, Hhd, Hh, Re, Ch, Re, Re^Es, Aa, Aa
Ww^Wkf, Ww^Wkf, Gs^Fmw, Gs^Fmw, Gg^Efm, Gd^Efm, Aa, Aa, Aa, Aa, Aa, Gg, Hh^Fmw, Mm, Hh^Fmw, Mm, Mm, Aa, Aa, Aa, Re, Re, Re^Es, Hhd, Hh, Hh, Gd, Re, Hhd^Ecf, Re, Re, Re^Es
Wwf, Wwr, Gg, Gg, Aa, Aa, Gd, Aa, Gs^Fmw, Aa^Fdw, Aa, Gs^Fmw, Gd, Hh^Vhh, Mm, Mm, Mm, Mm, Aa, Aa, Hh^Em, Hh^Em, Hhd^Em, Hh, Gg^Efm, Gd^Es, Hhd, Hhd, Hh, Hh, Hh, Hhd
Wwf, Wwf, Gll^Fdw, Gll^Fdw, Gg, Gs, Hhd^Vhhr, Gs, Hh, Gd, Gs, Gd^Fdw, Gd, Mm, Mm, Mm, Aa, Aa, Gd, Gs^Efm, Hh^Em, Hh^Emf, Hhd^Em, Hh^Vhh, Hh, Gs^Efm, Gs, Hh, Gg, Gs, Gd^Es, Hh
Ww, Wwf, Ww, Wwr, Wwr, Gs^Fdw, Hh, Hh^Fp, Hh^Fmw, Hh, Aa, Gd, Aa, Gs, Gd, Aa, Aa, Gs^Efm, Gg^Efm, Hh, Hhd, Hhd^Em, Hhd, Hhd, Gd, Gs, Gs, Hh, Hh^Em, Hh, Hh, Gs
Ww, Ww^Wkf, Gd, Ww, Wwr, Wwf, Wwf, Hh^Fp, Aa, Aa, Aa, Gs^Fmw, Aa, Aa^Fdw, Gs, Aa, Aa, Gs, Hh, Hh, Gd^Efm, Gs^Efm, Gd^Efm, Gd, Hh, Gd, Gs, Hhd^Em, Hhd^Emf, Hhd^Em, Hhd, Hh
Gs^Fmw, Gs^Fmw, Gd, Ww^Wkf, Ww, Wwr, Wwf, Hh^Fdw, Aa, Aa, Gs^Fmw, Gs^Fmw, Aa, Aa, Gs^Efm, Aa, Aa, Gd, Gs, Gs, Gd, Gd, Gd, Hh, Gd, Gd, Hh, Hhd, Gs, Gs, Gs, Gd
Hhd, Gd, Hh^Fdw, Gd, Gs^Fmw, Gd, Gs^Fdw, Gs^Fmw, Gg^Efm, Gg, Gs, Gs, Hh, Aa, Gd, Gd^Efm, Gd, Hh, Gd, Gd, Hh, Hh, Gs, Hh, Gd, Gs, Gd^Em, Gs^Em, Gd^Em, Gd, Mm, Hhd
Mm, Mm, Mm, Gd, Gd, Gs^Fdw, Gs^Fdw, Gs^Fmw, Aa, Aa, Gd^Em, Gd^Efm, Aa, Gd, Gs, Gd, Gs, Gs, Mm, Mm^Xm, Mm, Hh, Gs, Gd^Es, Gs, Gs, Gd^Em, Gd^Emf, Mm, Mm, Hhd, Hhd
Hhd, Mm, Mm, Mm, Mm, Gd, Gd, Gd, Aa, Aa, Gd^Emf, Aa, Aa, Aa, Mm, Mm, Mm, Hhd^Vhhr, Hhd, Mm, Mm, Gd, Gd^Efm, Hh, Gd, Gd, Mm, Mm, Mm, Hh, Mm, Hh
Hh, Hhd^Em, Hhd^Emf, Mm, Mm, Hh^Fp, Gd^Efm, Aa, Aa, Gs^Em, Gd, Aa, Mm, Mm, Mm, Mm, Mm, Hhd, Mm, Mm, Gd, Gd, Aa, Gd, Mm, Mm, Mm, Mm, Mm, Mm, Mm, Mm
Hh, Hh^Em, Mm, Mm, Mm, Mm, Mm, Gd^Efm, Gd, Gd, Hhd, Gd^Efm, Gd, Mm, Mm, Mm, Mm, Mm, Mm, Hhd, Gs, Aa, Aa, Gd, Aa, Mm, Aa, Mm, Mm, Mm, Hh^Em, Hh
Mm, Mm, Mm, Mm, Mm, Mm, Mm, Mm, Hh^Fp, Hh^Fdw, Gs^Efm, Hhd, Gd, Mm, Mm, Mm, Mm, Mm, Mm, Hh, Gs^Efm, Aa, Aa, Gs, Gs, Aa, Mm, Mm, Mm, Hh^Vhh, Hhd^Em, Hhd^Emf
Hhd, Mm, Mm, Mm, Mm, Hh, Hhd, Mm, Mm, Gg, Gg, Hhd, Hh^Fdw, Hh, Gs, Mm, Hh, Mm, Hhd, Hh^Vhh, Gs^Efm, Aa, Aa, Gg, Aa, Aa, Mm, Mm, Mm, Mm, Mm, Hhd^Em
Mm, Mm, Mm, Mm, Mm, Mm, Mm, Mm, Mm, Mm, Hh^Vhh, Gg^Efm, Gg, Gd^Efm, Gg, Gs, Gs^Em, Hh, Hh, Hh, Gs, Aa, Gd, Aa, Aa, Gg, Hh, Mm, Mm, Mm, Hhd, Hhd
Hhd, Mm, Mm, Mm, Mm, Mm, Mm, Mm, Mm, Mm, Mm, Mm, Wwr, Gg, Wwf, Wwf, Gd^Emf, Gd^Em, Gd, Gs, Aa, Hhd, Hhd, Gs^Es, Gs, Gg^Efm, Gs^Efm, Hhd, Mm^Xm, Hh, Hhd, Hh
Mm, Hhd, Hh, Mm, Hh, Hhd, Hh, Mm, Gs, Mm, Gs^Efm, Wwf, Wwf, Wwf, Wwf, Wwf, Gs^Em, Gd^Em, Aa, Aa, Aa, Aa, Aa, Hhd, Hhd, Wwf, Gg^Efm, Mm, Mm, Mm, Mm^Xm, Hh
Aa, Mm, Mm, Hh^Vhh, Gg^Efm, Gg, Gs, Gd^Es, Gg, Gg, Ww^Wkf, Gs, Gg, Ww^Wkf, Ww^Wkf, Ww^Ewl, Gd^Es, Gd, Hh, Aa, Aa, Aa, Aa, Aa, Hhd, Wwf, Wwf, Gg, Gd^Es, Mm, Mm, Mm
Aa, Aa, Aa, Re, Re, Wwf, Wwf, Gg^Efm, Wwr, Ww^Wkf, Ww^Ewl, Ww, Wwf, Wwr, Wwf, Gs, Gd, Gd, Gd, Aa, Gd^Es, Gs, Hhd, Aa, Hhd, Ww^Wkf, Ww^Wkf, Wwf, Wwf, Gs^Efm, Wwf, Wwf
Aa, Aa, Ch, Ch, Ch, Re^Es, Wwf, Wwr, Wwr, Wwf, Wwf, Wwf, Gd^Es, Wwf, Gd^Efm, Gd, Mm^Xm, Hh, Gd, Gs^Es, Hhd^Em, Hhd^Em, Hhd^Em, Hhd, Ww^Ewl, Ww^Wkf, Wwr, Wwr, Ww, Wwf, Ww^Ewl, Ww^Ewl
Aa, Aa, Ch, 4 Kh, Ch, Re^Es, Ww, Ww^Wkf, Gs^Ecf, Gd, Gd, Gs^Efm, Gd, Gd, Hh, Mm, Mm, Mm, Hh, Gs, Hhd, Hh^Em, Hhd^Em, Ww, Gs, Gd^Es, Gs^Efm, Ww^Wkf, Re, Re^Es, Re^Es, Ww^Ewf
Aa, Aa, Aa, Ch, Aa, Re^Efm, Re, Re^Es, Re, Re, Hh^Vhh, Gd, Hhd, Hhd, Mm, Hh, Mm, Mm^Xm, Mm, Gs, Gg^Efm, Hhd, Hh^Em, Gs, Hh, Gg, Gs^Efm, Re, Re, Re^Es, Ww^Wkf, Ww
Aa, Aa, Mm, Aa, Mm, Aa, Mm, Hh, Mm, Mm, Mm, Hh, Hhd, Mm, Mm, Mm, Mm, Mm, Hh, Gg, Gg^Efm, Hhd^Em, Hhd^Emf, Hhd^Vhhr, Gg, Gg, Chr, Gg^Efm, Re, Wwf, Wwf, Ww^Wkf
Mm, Mm, Hh, Mm, Mm, Mm, Mm, Mm, Mm, Mm, Mm, Mm, Mm, Mm, Mm, Mm, Mm, Mm, Hh^Vhh, Hh, Re, Hhd^Em, Hh^Em, Hh^Em, Gs, Chr, 1 Khr, Chr, Re, Wwf, Mm^Xm, Wwf
Hh, Hh, Mm, Mm, Mm, Mm, Mm, Mm, Mm, Mm, Hh, Mm, Mm, Mm, Mm, Mm, Hh, Hh, Mm, Hh, Re^Es, Hhd, Re^Es, Re, Re, Chr, Chr, Chr, Hhd, Mm, Mm, Mm
Hhd, Hhd, Mm, Mm, Mm, Mm, Mm, Mm, Mm, Mm, Mm, Hhd, Mm, Mm, Mm, Mm, Mm, Hh, Mm, Mm, Mm, Re, Mm, Mm, Mm, Hh, Hh, Hhd, Mm, Mm, Hhd, Hhd
Mm, Mm, Mm, Mm, Mm, Mm, Mm, Mm, Mm, Mm, Hhd, Mm, Mm, Mm, Mm, Mm, Mm, Mm, Mm, Mm, Mm, Mm, Mm, Mm, Mm, Mm, Mm, Mm, Hh^Vhh, Hhd, Mm, Hhd
Hh, Mm, Mm, Mm, Mm, Mm, Hh, Mm, Hh, Hh, Hh, Hhd, Hhd, Mm, Hh, Mm, Mm, Mm, Mm, Mm, Hh, Hh, Hh, Mm, Hh, Mm, Hh, Hh, Mm, Mm, Hh, Hh
