Xot, Xot, Aa, Aa, Aa, Xot, Xot, Xot, Xot, Xot, Xot, Xot, Xot, Xot, Xot, Xot, Xot, Xot, Xot, Xot, Xot, Xot, Xot, Xot, Xot, Xot, Xot
Xot, Xot, Aa, Aa, Aa, Xot, Xot, Xot, Xot, Xot, Xot, Xot, Xot, Xot, Xot, Xot, Xot, Xot, Xot, Xot, Xot, Xot, Xot, Xot, Xot, Xot, Xot
Xot, Xot, Aa, 1 Aa, Aa, Xot, Xot, Xot, Xot^Efs, Xot^Efs, Xot^Efs, Xot, Xot, Xot, Xot, Xot, Xot, Xot, Xot, Xot, Xot, Xot, Xot, Xot, Xot, Xot, Xot
Xot, Xot, Ai, Aa, Ai, Xot, Xot, Xot, Wwb, Uh, Uh^Tf, Xot^Efs, Xot^Efs, Xot^Efs, Xot^Efs, Xot, Xot, Xot, Xot, Xot, Xot, Xot, Xot^Efs, Xot, Xot, Xot, Xot
Xot, Xot, Cva, Ai, Cva, Xot^Efs, Xot, Xot^Efs, Wwb, Uh^Emf, Uue, Uh, Cud, Uh^Emf, Uh^Emf, Xot, Xot, Xot, Xot, Xot, Xot^Efs, Xot^Efs, Qxua, Xot^Efs, Xot^Efs, Xot, Xot
Xot, Xot, Uh, Cva, Uh, Uh, Xot^Efs, Wwb, Uu^Vu, Uu, Wwbf, Wwbf, Cud, Uh^Tf, Uh^Tf, Xot, Xot, Xot, Xot^Efs, Xot^Efs, Qxua, Qxua, Cud^Ebn, Qxua, Qxua, Xot, Xot
Xot, Xot, Wwb, Uh, Wwb, Uu, Wwbf, Wwbf, Wwbf, Wwbf, Xot^Efs, Xot^Efs, Uue, Uue, Uh^Tf, Xot^Efs, Xot, Xot, Qxua, Qxua, Uh, Cud^Ebn, Wwbf^Kov, Cud^Ebn, Qxua, Xot, Xot
Xot, Xot, Xot, Wwb, Xot, Uue, Uh, Uhe, Xot^Efs, Xot^Efs, Wwb, Wwb, Uue, Uu^Vu, Wwbf, Wwb, Xot, Xot, Qxua, Uh, Uh, Wwbf^Kov, Cud^Ebn, Cud^Ebn, Qxua, Xot, Xot
Xot, Xot, Xot, Xot, Xot^Efs, Xot^Efs, Xot^Efs, Xot, Wwb, Cud^Ebn, Uh, Uue, Uu, Wwbf, Wwb, Wwb, Xot, Xot, Qxua, Uh, Uh^Vu, Uh, Qxua^Ii, Qxua^Ii, Qxua, Xot, Xot
Xot, Xot, Xot, Xot, Wwb, Wwb, Wwbf, Xot, Cud, Cud, Uu, Uu, Wwbf, Uue, Uhe, Wwb, Xot, Xot, Qxua, Uh, Qxu^Bs|, Qxua^Ii, Uh, Uh, Qxua, Xot, Xot
Xot, Xot, Xot, Xot, Wwb, Wwbf, Uu, Xot^Efs, Uh, Uu, Uu, Wwbf, Uh^Tf, Uue, Xot, Xot, Xot, Xot, Uh, Qxua, Uh, Uh, Qxua^Ii, Qxu^Bs|, Qxua, Xot, Xot
Xot, Xot, Xot, Xot, Uue, Wwbf, Uu, Wwbf, Wwbf, Uu, Xot, Uh, Xot, Xot, Xot, Xot, Xot, Xot, Uh, Qxua, Qxua^Ii, Qxua^Ii, Uh, Uh, Qxua, Xot, Xot
Xot, Xot, Xot, Xot, Xot^Efs, Uue, Wwb, Uu^Vu, Uu, Uue, Xot^Efs, Xot, Xot^Efs, Xot^Efs, Xot^Efs, Xot, Xot, Xot, Uh, Qxua, Uh, Uh^Vu, Uh, Uh, Qxua, Xot, Xot
Xot, Xot, Xot, Xot, Cud^Ebn, Xot^Efs, Wwbf, Wwb, Wwbf, Xot^Efs, Cud, Xot, Cud, Wwbf, Cud^Ebn, Xot^Efs, Xot^Efs, Xot, Uh, Qxua, Qxua^Ii, Uh, Qxua^Ii, Qxua^Ii, Qxua, Xot, Xot
Xot, Xot, Xot, Xot, Cud^Ebn, Cud, Uue, Wwb, Wwbf, Wwbf, Cud, Xot, Uue, Cud, Uhe, Uhe, Wwb, Xot^Efs, Xot, Qxua, Uh, Qxu^Bs|, Cud^Ebn, Cud^Ebn, Cud^Ebn, Qxua, Xot
Xot, Xot, Xot, Xot, Xot, Uu, Uu, Uu, Wwbf, Cud, Uhe, Xot^Efs, Uue, Uhe, Xot, Uue, Uu, Wwb, Xot, Qxua, Qxua, Uh, Cud^Ebn, Wwbf^Kov, Cud^Ebn, Qxua, Xot
Xot, Xot, Xot, Xot, Xot, Xot, Xot, Wwbf, Xot, Uhe, Wwbf, Uue, Uu^Vu, Uu, Xot^Efs, Xot, Wwbf, Wwb, Xot^Efs, Xot^Efs, Xot^Efs, Qxua, Qxua, Cud^Ebn, Qxua, Qxua, Xot
Xot, Xot, Xot, Xot, Xot, Xot, Xot, Xot, Xot, Wwb, Wwbf, Uue, Uu, Uu, Wwb, Xot^Efs, Wwbf, Uhe^Tf, Uu, Wwb, Wwb, Xot, Xot, Qxua, Xot, Xot, Xot
Xot, Xot, Xot, Xot, Xot, Xot, Xot, Xot, Xot, Wwb, Wwb, Wwbf, Xot, Xot^Efs, Wwb, Wwb, Wwbf, Uhe^Tf, Uu, Wo^Ii, Wwb, Xot, Xot, Xot, Xot, Xot, Xot
Xot, Xot, Xot, Xot, Xot, Xot, Xot, Xot, Xot, Xot, Xot, Xot, Xot, Wwbf, Wwb, Wwbf, Cud, Uh^Emf, Xot, Wwb, Xot, Xot, Xot, Xot, Xot, Xot, Xot
Xot, Xot, Xot, Xot, Xot, Xot, Xot, Xot, Xot, Xot, Xot, Xot, Xot, Xot, Xot, Cud^Ebn, Xot, Xot, Xot, Xot, Xot, Xot, Xot, Xot, Xot, Xot, Xot
Xot, Xot, Xot, Xot, Xot, Xot, Xot, Xot, Xot, Xot, Xot, Xot, Xot, Xot, Xot, Xot, Xot, Xot, Xot, Xot, Xot, Xot, Xot, Xot, Xot, Xot, Xot
